data_somministrazione,area,totale,sesso_maschile,sesso_femminile,prima_dose,seconda_dose,codice_NUTS1,codice_NUTS2,codice_regione_ISTAT,nome_area
2020-12-31,LOM,713,300,413,713,0,ITC,ITC4,3,Lombardia
2021-02-01,PIE,8642,3053,5589,578,8064,ITC,ITC1,1,Piemonte
2021-02-01,UMB,1285,342,943,48,1237,ITI,ITI2,10,Umbria
2021-03-21,MOL,1246,542,704,479,767,ITF,ITF2,14,Molise
2021-05-18,LAZ,43654,19893,23761,34403,9251,ITI,ITI4,12,Lazio
2021-01-04,PAB,508,201,307,508,0,ITH,ITH1,4,Provincia Autonoma Bolzano / Bozen
2021-03-21,PUG,2689,1224,1465,585,2104,ITF,ITF4,16,Puglia
2021-04-15,BAS,3446,1675,1771,2638,808,ITF,ITF5,17,Basilicata
2021-04-23,TOS,25631,11410,14221,9337,16294,ITI,ITI1,9,Toscana
2021-01-30,CAL,2176,1149,1027,358,1818,ITF,ITF6,18,Calabria
2021-02-23,MOL,581,223,358,362,219,ITF,ITF2,14,Molise
2021-02-28,LOM,7889,3257,4632,7673,216,ITC,ITC4,3,Lombardia
2021-01-27,LAZ,6114,2387,3727,997,5117,ITI,ITI4,12,Lazio
2021-02-28,MAR,2836,1251,1585,2830,6,ITI,ITI3,11,Marche
2021-01-04,TOS,5065,1894,3171,5065,0,ITI,ITI1,9,Toscana
2021-02-19,PIE,5534,2175,3359,5033,501,ITC,ITC1,1,Piemonte
2021-05-10,PUG,36977,16317,20660,19288,17689,ITF,ITF4,16,Puglia
2021-04-07,FVG,7491,3319,4172,6710,781,ITH,ITH4,6,Friuli-Venezia Giulia
2021-05-14,EMR,35884,16542,19342,26462,9422,ITH,ITH5,8,Emilia-Romagna
2021-01-25,UMB,648,323,325,5,643,ITI,ITI2,10,Umbria
2021-03-03,TOS,18193,6510,11683,14587,3606,ITI,ITI1,9,Toscana
2021-04-18,SIC,19723,9862,9861,15358,4365,ITG,ITG1,19,Sicilia
2021-05-03,PAB,1829,846,983,417,1412,ITH,ITH1,4,Provincia Autonoma Bolzano / Bozen
2021-05-13,EMR,35346,16284,19062,27619,7727,ITH,ITH5,8,Emilia-Romagna
2021-04-04,CAM,7957,4011,3946,6913,1044,ITF,ITF3,15,Campania
2021-01-17,EMR,2890,887,2003,2644,246,ITH,ITH5,8,Emilia-Romagna
2021-03-07,MOL,1131,501,630,1129,2,ITF,ITF2,14,Molise
2021-03-19,LOM,32394,12896,19498,19215,13179,ITC,ITC4,3,Lombardia
2021-04-20,SAR,10848,4936,5912,7635,3213,ITG,ITG2,20,Sardegna
2021-04-02,CAL,8024,3664,4360,4200,3824,ITF,ITF6,18,Calabria
2021-05-06,PAT,5469,2708,2761,4692,777,ITH,ITH2,4,Provincia Autonoma Trento
2021-05-13,ABR,11130,5034,6096,7168,3962,ITF,ITF1,13,Abruzzo
2021-01-24,PUG,1670,749,921,154,1516,ITF,ITF4,16,Puglia
2021-04-13,LAZ,25579,11841,13738,17876,7703,ITI,ITI4,12,Lazio
2021-05-06,CAL,13201,6243,6958,8924,4277,ITF,ITF6,18,Calabria
2021-05-15,LAZ,56981,27214,29767,40589,16392,ITI,ITI4,12,Lazio
2021-01-07,LIG,3229,1095,2134,3229,0,ITC,ITC3,7,Liguria
2021-01-14,PAT,699,203,496,699,0,ITH,ITH2,4,Provincia Autonoma Trento
2021-02-15,LOM,8915,3120,5795,8494,421,ITC,ITC4,3,Lombardia
2021-02-17,SIC,5415,3280,2135,4746,669,ITG,ITG1,19,Sicilia
2021-03-15,VEN,16598,7263,9335,11381,5217,ITH,ITH3,5,Veneto
2020-12-31,EMR,2207,777,1430,2207,0,ITH,ITH5,8,Emilia-Romagna
2021-01-12,CAM,5214,2563,2651,5214,0,ITF,ITF3,15,Campania
2021-01-12,CAL,2061,1019,1042,2061,0,ITF,ITF6,18,Calabria
2021-03-11,TOS,15494,5993,9501,12168,3326,ITI,ITI1,9,Toscana
2021-05-17,ABR,11024,5038,5986,6167,4857,ITF,ITF1,13,Abruzzo
2021-01-08,LIG,2926,999,1927,2926,0,ITC,ITC3,7,Liguria
2021-01-17,ABR,187,59,128,180,7,ITF,ITF1,13,Abruzzo
2021-03-19,EMR,15573,6779,8794,7727,7846,ITH,ITH5,8,Emilia-Romagna
2021-04-02,CAM,21732,10410,11322,19411,2321,ITF,ITF3,15,Campania
2021-04-20,PUG,20931,9716,11215,17489,3442,ITF,ITF4,16,Puglia
2021-01-02,UMB,304,111,193,304,0,ITI,ITI2,10,Umbria
2021-01-24,FVG,305,119,186,1,304,ITH,ITH4,6,Friuli-Venezia Giulia
2021-02-05,PIE,9454,3080,6374,657,8797,ITC,ITC1,1,Piemonte
2021-03-17,ABR,4539,1873,2666,2800,1739,ITF,ITF1,13,Abruzzo
2021-01-30,PAT,386,132,254,152,234,ITH,ITH2,4,Provincia Autonoma Trento
2021-02-10,LAZ,8167,3388,4779,4850,3317,ITI,ITI4,12,Lazio
2021-02-19,CAM,9570,3559,6011,8920,650,ITF,ITF3,15,Campania
2021-03-09,VEN,16457,7377,9080,10141,6316,ITH,ITH3,5,Veneto
2021-04-10,CAM,28345,13487,14858,23429,4916,ITF,ITF3,15,Campania
2021-04-21,SIC,22664,10878,11786,16454,6210,ITG,ITG1,19,Sicilia
2021-02-20,PAB,1802,540,1262,1784,18,ITH,ITH1,4,Provincia Autonoma Bolzano / Bozen
2021-03-05,PAT,2242,703,1539,1676,566,ITH,ITH2,4,Provincia Autonoma Trento
2021-01-31,LAZ,4458,1853,2605,475,3983,ITI,ITI4,12,Lazio
2021-02-20,TOS,4641,1790,2851,4128,513,ITI,ITI1,9,Toscana
2021-02-28,ABR,1704,510,1194,1702,2,ITF,ITF1,13,Abruzzo
2021-04-05,PIE,14746,6233,8513,12189,2557,ITC,ITC1,1,Piemonte
2021-05-11,PAT,3674,1743,1931,2844,830,ITH,ITH2,4,Provincia Autonoma Trento
2021-05-13,VDA,1139,556,583,540,599,ITC,ITC2,2,Valle d'Aosta / Vallée d'Aoste
2021-05-14,VDA,959,442,517,291,668,ITC,ITC2,2,Valle d'Aosta / Vallée d'Aoste
2021-01-11,UMB,1315,346,969,1315,0,ITI,ITI2,10,Umbria
2021-03-15,PAT,1410,545,865,946,464,ITH,ITH2,4,Provincia Autonoma Trento
2021-03-09,UMB,4051,1971,2080,2759,1292,ITI,ITI2,10,Umbria
2021-04-12,UMB,7085,3075,4010,5368,1717,ITI,ITI2,10,Umbria
2021-02-18,LOM,14041,4926,9115,13013,1028,ITC,ITC4,3,Lombardia
2021-03-10,BAS,1651,814,837,812,839,ITF,ITF5,17,Basilicata
2021-03-11,PAB,1681,823,858,1143,538,ITH,ITH1,4,Provincia Autonoma Bolzano / Bozen
2021-05-12,CAM,40785,19909,20876,31655,9130,ITF,ITF3,15,Campania
2021-05-17,MAR,11857,5568,6289,7692,4165,ITI,ITI3,11,Marche
2021-04-12,EMR,19176,8978,10198,14746,4430,ITH,ITH5,8,Emilia-Romagna
2021-04-23,PAB,4539,2148,2391,3249,1290,ITH,ITH1,4,Provincia Autonoma Bolzano / Bozen
2021-05-12,PIE,31432,14956,16476,18769,12663,ITC,ITC1,1,Piemonte
2021-01-07,PAB,917,327,590,917,0,ITH,ITH1,4,Provincia Autonoma Bolzano / Bozen
2021-05-16,BAS,4959,2462,2497,2851,2108,ITF,ITF5,17,Basilicata
2021-01-13,MOL,474,160,314,474,0,ITF,ITF2,14,Molise
2021-03-29,VEN,31388,13630,17758,27556,3832,ITH,ITH3,5,Veneto
2021-05-10,SAR,9554,4245,5309,7037,2517,ITG,ITG2,20,Sardegna
2021-05-13,LOM,86001,41292,44709,58023,27978,ITC,ITC4,3,Lombardia
2021-01-02,VEN,5742,1765,3977,5742,0,ITH,ITH3,5,Veneto
2021-04-24,SIC,31339,14799,16540,23599,7740,ITG,ITG1,19,Sicilia
2021-01-26,BAS,793,350,443,101,692,ITF,ITF5,17,Basilicata
2021-04-25,PIE,20222,9302,10920,17718,2504,ITC,ITC1,1,Piemonte
2021-03-25,MAR,6657,2774,3883,3247,3410,ITI,ITI3,11,Marche
2021-04-26,EMR,27814,12891,14923,18524,9290,ITH,ITH5,8,Emilia-Romagna
2021-01-08,LOM,12669,3913,8756,12669,0,ITC,ITC4,3,Lombardia
2021-03-05,PUG,17113,6799,10314,14949,2164,ITF,ITF4,16,Puglia
2021-01-30,PUG,5527,2515,3012,411,5116,ITF,ITF4,16,Puglia
2021-04-29,PAT,4619,2231,2388,4410,209,ITH,ITH2,4,Provincia Autonoma Trento
2020-12-30,LOM,114,42,72,114,0,ITC,ITC4,3,Lombardia
2021-02-21,LOM,5052,1862,3190,5034,18,ITC,ITC4,3,Lombardia
2021-04-27,MAR,9400,4309,5091,5413,3987,ITI,ITI3,11,Marche
2021-01-19,TOS,1104,531,573,1104,0,ITI,ITI1,9,Toscana
2021-03-23,SIC,21064,10076,10988,15410,5654,ITG,ITG1,19,Sicilia
2021-03-20,VDA,208,86,122,172,36,ITC,ITC2,2,Valle d'Aosta / Vallée d'Aoste
2021-04-19,PIE,22526,10759,11767,18162,4364,ITC,ITC1,1,Piemonte
2021-04-26,ABR,8566,4067,4499,7350,1216,ITF,ITF1,13,Abruzzo
2021-02-13,LAZ,6610,2625,3985,6198,412,ITI,ITI4,12,Lazio
2021-01-31,BAS,77,24,53,0,77,ITF,ITF5,17,Basilicata
2021-03-18,TOS,9969,3980,5989,6005,3964,ITI,ITI1,9,Toscana
2021-03-28,LOM,20436,7790,12646,14272,6164,ITC,ITC4,3,Lombardia
2021-04-13,BAS,2115,1051,1064,1293,822,ITF,ITF5,17,Basilicata
2021-05-03,UMB,5083,2265,2818,2196,2887,ITI,ITI2,10,Umbria
2021-01-01,CAM,919,506,413,919,0,ITF,ITF3,15,Campania
2021-01-14,FVG,2584,789,1795,2584,0,ITH,ITH4,6,Friuli-Venezia Giulia
2021-01-23,ABR,263,114,149,57,206,ITF,ITF1,13,Abruzzo
2021-02-20,PIE,3832,1253,2579,3658,174,ITC,ITC1,1,Piemonte
2021-02-20,UMB,282,100,182,258,24,ITI,ITI2,10,Umbria
2021-03-29,SAR,4425,1559,2866,3837,588,ITG,ITG2,20,Sardegna
2021-05-10,VEN,36127,16855,19272,26433,9694,ITH,ITH3,5,Veneto
2021-03-26,CAM,19453,8926,10527,15641,3812,ITF,ITF3,15,Campania
2021-05-08,BAS,4838,2400,2438,3431,1407,ITF,ITF5,17,Basilicata
2021-04-25,TOS,11044,5247,5797,8907,2137,ITI,ITI1,9,Toscana
2021-05-16,VDA,686,339,347,347,339,ITC,ITC2,2,Valle d'Aosta / Vallée d'Aoste
2021-01-31,SIC,4108,1958,2150,113,3995,ITG,ITG1,19,Sicilia
2021-04-28,PIE,25930,11683,14247,15942,9988,ITC,ITC1,1,Piemonte
2021-02-11,CAM,6278,2704,3574,6212,66,ITF,ITF3,15,Campania
2021-02-13,TOS,7785,2360,5425,7558,227,ITI,ITI1,9,Toscana
2021-01-02,SAR,60,21,39,60,0,ITG,ITG2,20,Sardegna
2021-02-01,PAB,1451,440,1011,12,1439,ITH,ITH1,4,Provincia Autonoma Bolzano / Bozen
2021-02-19,LIG,3211,1304,1907,3035,176,ITC,ITC3,7,Liguria
2021-03-18,LAZ,14224,6078,8146,7834,6390,ITI,ITI4,12,Lazio
2021-04-06,ABR,7684,3583,4101,5365,2319,ITF,ITF1,13,Abruzzo
2021-04-09,VDA,237,111,126,204,33,ITC,ITC2,2,Valle d'Aosta / Vallée d'Aoste
2021-02-09,ABR,908,311,597,499,409,ITF,ITF1,13,Abruzzo
2021-03-22,ABR,4281,1852,2429,2311,1970,ITF,ITF1,13,Abruzzo
2021-01-21,PAT,351,94,257,228,123,ITH,ITH2,4,Provincia Autonoma Trento
2021-02-27,FVG,3516,1200,2316,3515,1,ITH,ITH4,6,Friuli-Venezia Giulia
2021-03-08,BAS,1452,708,744,841,611,ITF,ITF5,17,Basilicata
2021-02-01,TOS,5509,1958,3551,521,4988,ITI,ITI1,9,Toscana
2021-02-02,MOL,539,176,363,216,323,ITF,ITF2,14,Molise
2021-03-04,PAT,2352,790,1562,1574,778,ITH,ITH2,4,Provincia Autonoma Trento
2021-03-28,EMR,12972,5769,7203,9338,3634,ITH,ITH5,8,Emilia-Romagna
2021-04-20,VEN,22384,9483,12901,8391,13993,ITH,ITH3,5,Veneto
2021-02-04,ABR,1681,615,1066,609,1072,ITF,ITF1,13,Abruzzo
2021-02-16,MAR,1287,475,812,1257,30,ITI,ITI3,11,Marche
2021-05-19,LOM,57339,27432,29907,21084,36255,ITC,ITC4,3,Lombardia
2021-02-10,SIC,4421,1814,2607,3999,422,ITG,ITG1,19,Sicilia
2021-02-25,LAZ,12658,5520,7138,11608,1050,ITI,ITI4,12,Lazio
2021-03-09,SAR,5150,2371,2779,4421,729,ITG,ITG2,20,Sardegna
2021-03-20,EMR,16071,6825,9246,9107,6964,ITH,ITH5,8,Emilia-Romagna
2021-02-09,LOM,12285,3344,8941,4113,8172,ITC,ITC4,3,Lombardia
2021-04-06,LOM,43009,17550,25459,25056,17953,ITC,ITC4,3,Lombardia
2021-04-28,CAM,36390,17609,18781,26646,9744,ITF,ITF3,15,Campania
2021-05-10,PAT,3203,1644,1559,2701,502,ITH,ITH2,4,Provincia Autonoma Trento
2021-02-25,TOS,10632,4305,6327,9633,999,ITI,ITI1,9,Toscana
2021-03-15,PUG,11767,5619,6148,5269,6498,ITF,ITF4,16,Puglia
2021-03-26,PIE,17746,6981,10765,8840,8906,ITC,ITC1,1,Piemonte
2021-03-27,BAS,2206,837,1369,1816,390,ITF,ITF5,17,Basilicata
2021-04-05,PAB,301,144,157,23,278,ITH,ITH1,4,Provincia Autonoma Bolzano / Bozen
2021-02-07,EMR,4793,1537,3256,1732,3061,ITH,ITH5,8,Emilia-Romagna
2021-02-24,VDA,183,82,101,164,19,ITC,ITC2,2,Valle d'Aosta / Vallée d'Aoste
2021-04-14,CAL,7945,3842,4103,6492,1453,ITF,ITF6,18,Calabria
2021-01-23,MAR,557,190,367,123,434,ITI,ITI3,11,Marche
2021-05-01,MOL,2628,1262,1366,408,2220,ITF,ITF2,14,Molise
2021-01-26,LAZ,7956,3125,4831,724,7232,ITI,ITI4,12,Lazio
2021-01-02,FVG,1216,470,746,1216,0,ITH,ITH4,6,Friuli-Venezia Giulia
2021-03-22,MAR,5655,2376,3279,2527,3128,ITI,ITI3,11,Marche
2021-04-06,EMR,24611,11106,13505,19875,4736,ITH,ITH5,8,Emilia-Romagna
2021-05-06,PUG,38965,17011,21954,19441,19524,ITF,ITF4,16,Puglia
2021-01-24,PAT,547,276,271,224,323,ITH,ITH2,4,Provincia Autonoma Trento
2021-04-05,TOS,15279,6823,8456,14542,737,ITI,ITI1,9,Toscana
2021-01-14,PUG,4069,1589,2480,4069,0,ITF,ITF4,16,Puglia
2021-02-10,BAS,547,237,310,495,52,ITF,ITF5,17,Basilicata
2021-02-18,LIG,2762,1126,1636,2431,331,ITC,ITC3,7,Liguria
2021-03-12,MOL,1459,637,822,1423,36,ITF,ITF2,14,Molise
2021-03-15,SAR,2685,1216,1469,2312,373,ITG,ITG2,20,Sardegna
2021-03-21,PAT,129,69,60,129,0,ITH,ITH2,4,Provincia Autonoma Trento
2021-05-11,FVG,8783,4190,4593,7025,1758,ITH,ITH4,6,Friuli-Venezia Giulia
2021-05-19,EMR,16441,7528,8913,9276,7165,ITH,ITH5,8,Emilia-Romagna
2021-01-29,VDA,318,138,180,2,316,ITC,ITC2,2,Valle d'Aosta / Vallée d'Aoste
2021-05-09,SIC,28144,13163,14981,19873,8271,ITG,ITG1,19,Sicilia
2020-12-28,SAR,65,25,40,65,0,ITG,ITG2,20,Sardegna
2021-01-03,TOS,3335,1051,2284,3335,0,ITI,ITI1,9,Toscana
2021-01-29,BAS,613,229,384,63,550,ITF,ITF5,17,Basilicata
2021-02-06,TOS,4527,1550,2977,1294,3233,ITI,ITI1,9,Toscana
2021-04-10,UMB,7442,3499,3943,7329,113,ITI,ITI2,10,Umbria
2021-02-26,SAR,2800,1108,1692,2494,306,ITG,ITG2,20,Sardegna
2021-05-19,BAS,2017,1063,954,756,1261,ITF,ITF5,17,Basilicata
2021-01-20,LAZ,4802,1939,2863,3259,1543,ITI,ITI4,12,Lazio
2021-02-07,BAS,373,159,214,49,324,ITF,ITF5,17,Basilicata
2021-03-04,FVG,3428,1592,1836,2785,643,ITH,ITH4,6,Friuli-Venezia Giulia
2021-02-06,PAB,2626,1171,1455,19,2607,ITH,ITH1,4,Provincia Autonoma Bolzano / Bozen
2021-03-02,LAZ,17004,7439,9565,13070,3934,ITI,ITI4,12,Lazio
2021-03-12,CAM,14246,7095,7151,8164,6082,ITF,ITF3,15,Campania
2021-05-02,TOS,11158,4922,6236,9200,1958,ITI,ITI1,9,Toscana
2021-01-13,SAR,573,178,395,573,0,ITG,ITG2,20,Sardegna
2021-03-03,PUG,16645,6692,9953,14737,1908,ITF,ITF4,16,Puglia
2021-03-29,ABR,5625,2524,3101,2986,2639,ITF,ITF1,13,Abruzzo
2021-04-17,PAB,5230,2598,2632,5186,44,ITH,ITH1,4,Provincia Autonoma Bolzano / Bozen
2021-03-28,BAS,2139,741,1398,2122,17,ITF,ITF5,17,Basilicata
2021-05-02,PAB,2457,1288,1169,1536,921,ITH,ITH1,4,Provincia Autonoma Bolzano / Bozen
2021-04-13,TOS,8488,3506,4982,6031,2457,ITI,ITI1,9,Toscana
2021-04-14,PUG,31759,14986,16773,28453,3306,ITF,ITF4,16,Puglia
2021-05-08,LAZ,45141,20593,24548,29798,15343,ITI,ITI4,12,Lazio
2021-02-15,ABR,1794,831,963,1752,42,ITF,ITF1,13,Abruzzo
2021-03-05,EMR,17652,5740,11912,14215,3437,ITH,ITH5,8,Emilia-Romagna
2021-03-21,SAR,4030,1809,2221,2590,1440,ITG,ITG2,20,Sardegna
2021-04-17,TOS,20513,9196,11317,18391,2122,ITI,ITI1,9,Toscana
2021-01-18,CAM,957,399,558,713,244,ITF,ITF3,15,Campania
2021-03-15,LOM,31568,11333,20235,23050,8518,ITC,ITC4,3,Lombardia
2021-04-27,SIC,26355,12700,13655,15574,10781,ITG,ITG1,19,Sicilia
2020-12-29,LIG,125,33,92,125,0,ITC,ITC3,7,Liguria
2021-01-02,MAR,453,139,314,453,0,ITI,ITI3,11,Marche
2021-02-23,SAR,1519,1010,509,1285,234,ITG,ITG2,20,Sardegna
2021-04-30,PAB,3337,1592,1745,1561,1776,ITH,ITH1,4,Provincia Autonoma Bolzano / Bozen
2021-05-11,VDA,645,325,320,494,151,ITC,ITC2,2,Valle d'Aosta / Vallée d'Aoste
2021-03-13,CAM,14249,6794,7455,8967,5282,ITF,ITF3,15,Campania
2021-03-26,FVG,5796,2423,3373,3785,2011,ITH,ITH4,6,Friuli-Venezia Giulia
2021-03-29,VDA,493,233,260,453,40,ITC,ITC2,2,Valle d'Aosta / Vallée d'Aoste
2021-02-19,LOM,14115,5369,8746,13435,680,ITC,ITC4,3,Lombardia
2021-02-26,TOS,10076,3832,6244,8870,1206,ITI,ITI1,9,Toscana
2021-03-20,BAS,1286,566,720,275,1011,ITF,ITF5,17,Basilicata
2021-01-10,LAZ,4039,1700,2339,4039,0,ITI,ITI4,12,Lazio
2021-01-30,EMR,10077,3519,6558,141,9936,ITH,ITH5,8,Emilia-Romagna
2021-02-22,CAM,10681,3295,7386,10418,263,ITF,ITF3,15,Campania
2021-03-24,MOL,1630,658,972,1228,402,ITF,ITF2,14,Molise
2021-04-04,CAL,1733,876,857,1233,500,ITF,ITF6,18,Calabria
2021-01-13,PUG,4540,1731,2809,4540,0,ITF,ITF4,16,Puglia
2021-02-03,PAB,1503,478,1025,5,1498,ITH,ITH1,4,Provincia Autonoma Bolzano / Bozen
2021-02-24,BAS,1803,743,1060,1734,69,ITF,ITF5,17,Basilicata
2021-02-23,PUG,9342,4421,4921,8867,475,ITF,ITF4,16,Puglia
2021-04-06,BAS,1266,461,805,1082,184,ITF,ITF5,17,Basilicata
2021-02-05,UMB,780,234,546,18,762,ITI,ITI2,10,Umbria
2021-02-15,MAR,967,412,555,954,13,ITI,ITI3,11,Marche
2021-04-19,FVG,6703,3129,3574,3292,3411,ITH,ITH4,6,Friuli-Venezia Giulia
2021-05-11,MAR,10623,4832,5791,5678,4945,ITI,ITI3,11,Marche
2021-01-07,FVG,2090,717,1373,2090,0,ITH,ITH4,6,Friuli-Venezia Giulia
2021-01-19,PIE,6456,2104,4352,6444,12,ITC,ITC1,1,Piemonte
2021-01-19,UMB,103,23,80,103,0,ITI,ITI2,10,Umbria
2021-02-11,LIG,1975,767,1208,1104,871,ITC,ITC3,7,Liguria
2021-03-18,VEN,12599,5133,7466,7373,5226,ITH,ITH3,5,Veneto
2021-03-29,MAR,5860,2567,3293,3435,2425,ITI,ITI3,11,Marche
2021-04-28,FVG,7224,3186,4038,3760,3464,ITH,ITH4,6,Friuli-Venezia Giulia
2021-03-08,TOS,6369,2630,3739,1550,4819,ITI,ITI1,9,Toscana
2021-03-11,SAR,6035,2725,3310,4834,1201,ITG,ITG2,20,Sardegna
2021-04-28,LIG,14447,6520,7927,6459,7988,ITC,ITC3,7,Liguria
2021-01-08,FVG,2322,747,1575,2322,0,ITH,ITH4,6,Friuli-Venezia Giulia
2021-01-11,EMR,9335,3269,6066,9335,0,ITH,ITH5,8,Emilia-Romagna
2021-01-16,CAM,3369,1675,1694,3369,0,ITF,ITF3,15,Campania
2021-03-15,VDA,362,123,239,159,203,ITC,ITC2,2,Valle d'Aosta / Vallée d'Aoste
2021-04-15,PIE,29568,13555,16013,24096,5472,ITC,ITC1,1,Piemonte
2021-01-01,LIG,144,55,89,144,0,ITC,ITC3,7,Liguria
2021-01-06,CAM,7653,3750,3903,7653,0,ITF,ITF3,15,Campania
2021-03-16,CAL,3763,1845,1918,2176,1587,ITF,ITF6,18,Calabria
2021-01-12,LOM,20139,6677,13462,20139,0,ITC,ITC4,3,Lombardia
2021-04-25,PAT,1969,938,1031,1963,6,ITH,ITH2,4,Provincia Autonoma Trento
2021-02-03,TOS,4221,1452,2769,241,3980,ITI,ITI1,9,Toscana
2021-03-16,CAM,8086,3519,4567,3772,4314,ITF,ITF3,15,Campania
2021-03-26,LIG,9121,3854,5267,5967,3154,ITC,ITC3,7,Liguria
2021-04-26,BAS,4460,2163,2297,4240,220,ITF,ITF5,17,Basilicata
2021-05-07,LAZ,47998,22510,25488,30403,17595,ITI,ITI4,12,Lazio
2021-01-22,TOS,2866,1064,1802,528,2338,ITI,ITI1,9,Toscana
2021-01-25,EMR,6436,2137,4299,199,6237,ITH,ITH5,8,Emilia-Romagna
2021-02-26,PAB,1525,550,975,1495,30,ITH,ITH1,4,Provincia Autonoma Bolzano / Bozen
2021-02-05,VEN,8370,2534,5836,1425,6945,ITH,ITH3,5,Veneto
2021-02-08,CAM,5112,2449,2663,4310,802,ITF,ITF3,15,Campania
2021-02-12,TOS,7606,2683,4923,7393,213,ITI,ITI1,9,Toscana
2021-03-23,MOL,1642,694,948,1435,207,ITF,ITF2,14,Molise
2021-03-06,PAB,3969,2079,1890,3758,211,ITH,ITH1,4,Provincia Autonoma Bolzano / Bozen
2021-03-07,PUG,4915,1940,2975,4344,571,ITF,ITF4,16,Puglia
2021-03-19,ABR,5793,2584,3209,2774,3019,ITF,ITF1,13,Abruzzo
2021-04-02,LOM,41055,16795,24260,26660,14395,ITC,ITC4,3,Lombardia
2021-05-14,ABR,10603,5078,5525,5445,5158,ITF,ITF1,13,Abruzzo
2021-01-07,SAR,3111,1077,2034,3111,0,ITG,ITG2,20,Sardegna
2021-05-09,MOL,2038,926,1112,1943,95,ITF,ITF2,14,Molise
2021-05-12,UMB,6407,2991,3416,4273,2134,ITI,ITI2,10,Umbria
2021-01-22,PAB,248,143,105,124,124,ITH,ITH1,4,Provincia Autonoma Bolzano / Bozen
2021-02-25,CAL,2782,1497,1285,2204,578,ITF,ITF6,18,Calabria
2021-03-08,LAZ,20062,8312,11750,14789,5273,ITI,ITI4,12,Lazio
2021-04-03,CAM,21111,10314,10797,18733,2378,ITF,ITF3,15,Campania
2021-04-19,PUG,27412,12725,14687,24382,3030,ITF,ITF4,16,Puglia
2021-04-22,TOS,35695,15287,20408,18264,17431,ITI,ITI1,9,Toscana
2021-05-07,TOS,31972,14635,17337,11962,20010,ITI,ITI1,9,Toscana
2021-01-16,PIE,7771,2630,5141,7771,0,ITC,ITC1,1,Piemonte
2021-02-13,PIE,4152,1334,2818,2931,1221,ITC,ITC1,1,Piemonte
2021-03-09,MAR,5429,2293,3136,4549,880,ITI,ITI3,11,Marche
2021-04-23,SAR,12786,5704,7082,7364,5422,ITG,ITG2,20,Sardegna
2021-05-06,MAR,12656,5819,6837,5583,7073,ITI,ITI3,11,Marche
2021-01-18,PIE,6164,2047,4117,5916,248,ITC,ITC1,1,Piemonte
2021-03-16,LOM,25475,10112,15363,16419,9056,ITC,ITC4,3,Lombardia
2021-04-05,PAT,34,17,17,33,1,ITH,ITH2,4,Provincia Autonoma Trento
2021-01-21,ABR,157,47,110,157,0,ITF,ITF1,13,Abruzzo
2021-03-13,LIG,3826,1616,2210,2971,855,ITC,ITC3,7,Liguria
2021-02-07,ABR,777,307,470,201,576,ITF,ITF1,13,Abruzzo
2021-01-07,UMB,1300,387,913,1300,0,ITI,ITI2,10,Umbria
2021-02-26,UMB,660,253,407,652,8,ITI,ITI2,10,Umbria
2021-04-01,PIE,19322,8068,11254,11203,8119,ITC,ITC1,1,Piemonte
2021-01-13,VEN,5986,1607,4379,5986,0,ITH,ITH3,5,Veneto
2021-03-13,PAB,2885,1459,1426,2784,101,ITH,ITH1,4,Provincia Autonoma Bolzano / Bozen
2021-04-16,PAB,2949,1418,1531,2438,511,ITH,ITH1,4,Provincia Autonoma Bolzano / Bozen
2021-02-21,VDA,18,3,15,0,18,ITC,ITC2,2,Valle d'Aosta / Vallée d'Aoste
2021-03-21,VEN,11983,4754,7229,8521,3462,ITH,ITH3,5,Veneto
2021-04-29,MAR,13246,6061,7185,7149,6097,ITI,ITI3,11,Marche
2020-12-27,MOL,50,20,30,50,0,ITF,ITF2,14,Molise
2021-01-01,LOM,24,7,17,24,0,ITC,ITC4,3,Lombardia
2021-04-16,TOS,28912,12872,16040,22021,6891,ITI,ITI1,9,Toscana
2021-04-25,PUG,11089,5139,5950,9943,1146,ITF,ITF4,16,Puglia
2021-01-09,VDA,443,199,244,443,0,ITC,ITC2,2,Valle d'Aosta / Vallée d'Aoste
2021-01-21,EMR,2156,727,1429,811,1345,ITH,ITH5,8,Emilia-Romagna
2021-03-12,LIG,6151,2814,3337,3683,2468,ITC,ITC3,7,Liguria
2021-04-20,LOM,67595,30805,36790,57279,10316,ITC,ITC4,3,Lombardia
2021-01-21,VDA,33,12,21,33,0,ITC,ITC2,2,Valle d'Aosta / Vallée d'Aoste
2021-02-03,UMB,725,174,551,67,658,ITI,ITI2,10,Umbria
2021-02-03,PIE,10197,3303,6894,611,9586,ITC,ITC1,1,Piemonte
2021-03-28,ABR,2415,1017,1398,2044,371,ITF,ITF1,13,Abruzzo
2021-04-23,VEN,31085,13779,17306,22391,8694,ITH,ITH3,5,Veneto
2021-05-13,BAS,5978,2963,3015,3383,2595,ITF,ITF5,17,Basilicata
2021-03-07,CAL,3131,1561,1570,3042,89,ITF,ITF6,18,Calabria
2021-03-07,PAT,22,6,16,22,0,ITH,ITH2,4,Provincia Autonoma Trento
2021-04-08,LAZ,26645,12169,14476,18965,7680,ITI,ITI4,12,Lazio
2021-05-12,FVG,10541,4867,5674,9213,1328,ITH,ITH4,6,Friuli-Venezia Giulia
2021-02-05,PAB,3195,1181,2014,8,3187,ITH,ITH1,4,Provincia Autonoma Bolzano / Bozen
2021-02-12,PIE,6890,2214,4676,3930,2960,ITC,ITC1,1,Piemonte
2021-02-16,VDA,325,53,272,320,5,ITC,ITC2,2,Valle d'Aosta / Vallée d'Aoste
2021-03-03,PAT,1654,621,1033,1137,517,ITH,ITH2,4,Provincia Autonoma Trento
2021-03-11,VEN,19693,8766,10927,14109,5584,ITH,ITH3,5,Veneto
2021-01-07,VEN,8358,2318,6040,8358,0,ITH,ITH3,5,Veneto
2021-02-21,MAR,376,141,235,375,1,ITI,ITI3,11,Marche
2021-04-11,EMR,15220,6907,8313,12189,3031,ITH,ITH5,8,Emilia-Romagna
2021-04-21,MOL,1860,787,1073,965,895,ITF,ITF2,14,Molise
2021-05-19,ABR,6858,3245,3613,4620,2238,ITF,ITF1,13,Abruzzo
2021-02-26,VEN,8288,3267,5021,7036,1252,ITH,ITH3,5,Veneto
2021-05-12,LIG,11933,5352,6581,6594,5339,ITC,ITC3,7,Liguria
2021-01-04,PIE,5563,1679,3884,5563,0,ITC,ITC1,1,Piemonte
2021-05-08,SIC,35744,17073,18671,25431,10313,ITG,ITG1,19,Sicilia
2021-05-10,LOM,85055,40821,44234,63655,21400,ITC,ITC4,3,Lombardia
2021-01-04,UMB,810,398,412,810,0,ITI,ITI2,10,Umbria
2021-01-19,PAB,853,371,482,723,130,ITH,ITH1,4,Provincia Autonoma Bolzano / Bozen
2021-03-25,VDA,389,154,235,379,10,ITC,ITC2,2,Valle d'Aosta / Vallée d'Aoste
2021-04-19,PAT,2620,1234,1386,2597,23,ITH,ITH2,4,Provincia Autonoma Trento
2021-01-13,PAT,421,123,298,421,0,ITH,ITH2,4,Provincia Autonoma Trento
2021-01-21,LOM,5342,1569,3773,4653,689,ITC,ITC4,3,Lombardia
2021-02-11,CAL,2332,1042,1290,1081,1251,ITF,ITF6,18,Calabria
2021-02-18,FVG,3217,1492,1725,2811,406,ITH,ITH4,6,Friuli-Venezia Giulia
2021-03-18,SAR,7253,3069,4184,5650,1603,ITG,ITG2,20,Sardegna
2021-05-15,CAL,26625,12733,13892,19869,6756,ITF,ITF6,18,Calabria
2021-02-19,FVG,3250,1289,1961,2823,427,ITH,ITH4,6,Friuli-Venezia Giulia
2021-03-11,UMB,3565,1697,1868,2559,1006,ITI,ITI2,10,Umbria
2021-05-14,BAS,5898,2793,3105,3367,2531,ITF,ITF5,17,Basilicata
2021-01-17,BAS,328,133,195,327,1,ITF,ITF5,17,Basilicata
2021-01-18,LIG,2134,744,1390,1977,157,ITC,ITC3,7,Liguria
2021-02-05,SAR,1897,749,1148,433,1464,ITG,ITG2,20,Sardegna
2021-02-06,UMB,396,138,258,34,362,ITI,ITI2,10,Umbria
2021-04-01,CAM,24339,11687,12652,20207,4132,ITF,ITF3,15,Campania
2021-01-10,SIC,3620,1616,2004,3620,0,ITG,ITG1,19,Sicilia
2021-04-10,LIG,7877,3556,4321,6963,914,ITC,ITC3,7,Liguria
2021-01-16,LIG,1278,557,721,1278,0,ITC,ITC3,7,Liguria
2021-04-14,PAT,3112,1463,1649,2376,736,ITH,ITH2,4,Provincia Autonoma Trento
2021-02-07,VDA,292,120,172,190,102,ITC,ITC2,2,Valle d'Aosta / Vallée d'Aoste
2021-02-22,LIG,3335,1468,1867,3193,142,ITC,ITC3,7,Liguria
2021-02-23,VEN,7373,3247,4126,7107,266,ITH,ITH3,5,Veneto
2021-04-10,PAB,5390,2664,2726,4802,588,ITH,ITH1,4,Provincia Autonoma Bolzano / Bozen
2021-03-19,BAS,2289,992,1297,261,2028,ITF,ITF5,17,Basilicata
2021-04-18,MOL,611,264,347,104,507,ITF,ITF2,14,Molise
2021-02-21,ABR,1218,550,668,1217,1,ITF,ITF1,13,Abruzzo
2021-02-23,PAT,1108,395,713,897,211,ITH,ITH2,4,Provincia Autonoma Trento
2021-03-16,LIG,6073,2722,3351,2349,3724,ITC,ITC3,7,Liguria
2021-04-02,LIG,11671,5117,6554,9185,2486,ITC,ITC3,7,Liguria
2021-04-28,LOM,95536,43596,51940,68685,26851,ITC,ITC4,3,Lombardia
2021-04-04,LIG,756,366,390,507,249,ITC,ITC3,7,Liguria
2021-01-03,PIE,3063,967,2096,3063,0,ITC,ITC1,1,Piemonte
2021-03-14,SIC,8837,3951,4886,4978,3859,ITG,ITG1,19,Sicilia
2021-02-17,SAR,1407,577,830,1333,74,ITG,ITG2,20,Sardegna
2021-02-24,PUG,10033,4702,5331,9444,589,ITF,ITF4,16,Puglia
2021-03-06,SAR,2639,1079,1560,858,1781,ITG,ITG2,20,Sardegna
2021-03-06,EMR,20576,5872,14704,17848,2728,ITH,ITH5,8,Emilia-Romagna
2021-04-15,CAM,34331,16654,17677,24435,9896,ITF,ITF3,15,Campania
2020-12-27,CAL,279,154,125,279,0,ITF,ITF6,18,Calabria
2021-01-06,UMB,846,325,521,846,0,ITI,ITI2,10,Umbria
2021-01-22,SAR,83,47,36,55,28,ITG,ITG2,20,Sardegna
2021-01-29,CAM,10052,4812,5240,47,10005,ITF,ITF3,15,Campania
2021-01-29,PUG,6192,2659,3533,436,5756,ITF,ITF4,16,Puglia
2021-01-22,ABR,118,57,61,118,0,ITF,ITF1,13,Abruzzo
2021-03-05,ABR,5308,1948,3360,4610,698,ITF,ITF1,13,Abruzzo
2021-03-18,PAT,2317,957,1360,1238,1079,ITH,ITH2,4,Provincia Autonoma Trento
2021-03-31,SAR,10147,4047,6100,7700,2447,ITG,ITG2,20,Sardegna
2021-05-07,LOM,91629,43455,48174,69747,21882,ITC,ITC4,3,Lombardia
2021-01-05,LIG,2879,896,1983,2879,0,ITC,ITC3,7,Liguria
2021-03-30,TOS,16855,7492,9363,13291,3564,ITI,ITI1,9,Toscana
2021-01-21,BAS,30,10,20,30,0,ITF,ITF5,17,Basilicata
2021-03-02,TOS,10600,3799,6801,7156,3444,ITI,ITI1,9,Toscana
2021-03-08,LOM,29747,11176,18571,22678,7069,ITC,ITC4,3,Lombardia
2021-03-16,EMR,12239,5025,7214,4932,7307,ITH,ITH5,8,Emilia-Romagna
2021-03-27,PAT,1615,709,906,1363,252,ITH,ITH2,4,Provincia Autonoma Trento
2021-04-17,EMR,26964,12898,14066,17694,9270,ITH,ITH5,8,Emilia-Romagna
2021-05-04,PIE,28372,13030,15342,16322,12050,ITC,ITC1,1,Piemonte
2021-04-01,MAR,7578,3183,4395,4162,3416,ITI,ITI3,11,Marche
2021-04-17,SAR,10060,4492,5568,5463,4597,ITG,ITG2,20,Sardegna
2021-01-22,EMR,1828,477,1351,1088,740,ITH,ITH5,8,Emilia-Romagna
2021-02-03,MAR,2124,741,1383,119,2005,ITI,ITI3,11,Marche
2021-04-26,PUG,25984,11894,14090,22743,3241,ITF,ITF4,16,Puglia
2021-01-10,MOL,270,72,198,270,0,ITF,ITF2,14,Molise
2021-02-08,FVG,2357,694,1663,92,2265,ITH,ITH4,6,Friuli-Venezia Giulia
2021-02-09,MOL,359,170,189,197,162,ITF,ITF2,14,Molise
2021-04-01,LIG,12379,5468,6911,9609,2770,ITC,ITC3,7,Liguria
2021-04-22,PAB,2923,1500,1423,1981,942,ITH,ITH1,4,Provincia Autonoma Bolzano / Bozen
2021-05-16,PIE,28074,12749,15325,15044,13030,ITC,ITC1,1,Piemonte
2021-05-07,EMR,34462,16573,17889,22677,11785,ITH,ITH5,8,Emilia-Romagna
2021-01-31,MOL,268,70,198,6,262,ITF,ITF2,14,Molise
2021-02-13,PAT,536,333,203,171,365,ITH,ITH2,4,Provincia Autonoma Trento
2021-05-13,CAL,15836,7582,8254,11207,4629,ITF,ITF6,18,Calabria
2021-02-26,ABR,3916,1670,2246,2948,968,ITF,ITF1,13,Abruzzo
2021-03-03,SAR,3857,2071,1786,2610,1247,ITG,ITG2,20,Sardegna
2021-02-12,PUG,4101,1629,2472,3010,1091,ITF,ITF4,16,Puglia
2021-02-16,SAR,700,289,411,673,27,ITG,ITG2,20,Sardegna
2021-03-01,PAB,917,220,697,917,0,ITH,ITH1,4,Provincia Autonoma Bolzano / Bozen
2021-04-06,MOL,1493,700,793,1150,343,ITF,ITF2,14,Molise
2021-04-30,ABR,12372,5791,6581,6701,5671,ITF,ITF1,13,Abruzzo
2021-01-15,MAR,1771,500,1271,1771,0,ITI,ITI3,11,Marche
2021-01-22,LOM,3105,866,2239,3035,70,ITC,ITC4,3,Lombardia
2021-01-30,VDA,439,202,237,14,425,ITC,ITC2,2,Valle d'Aosta / Vallée d'Aoste
2021-02-27,PIE,12685,4848,7837,12340,345,ITC,ITC1,1,Piemonte
2021-05-07,SAR,13864,6347,7517,9541,4323,ITG,ITG2,20,Sardegna
2021-05-16,PUG,23842,10749,13093,12413,11429,ITF,ITF4,16,Puglia
2021-05-18,PUG,27253,12578,14675,15210,12043,ITF,ITF4,16,Puglia
2021-01-12,ABR,1804,666,1138,1804,0,ITF,ITF1,13,Abruzzo
2021-02-16,PAB,530,205,325,530,0,ITH,ITH1,4,Provincia Autonoma Bolzano / Bozen
2021-03-14,UMB,66,48,18,66,0,ITI,ITI2,10,Umbria
2021-03-15,SIC,10812,4712,6100,5746,5066,ITG,ITG1,19,Sicilia
2021-05-04,CAM,48420,23328,25092,39537,8883,ITF,ITF3,15,Campania
2021-01-08,MOL,429,141,288,429,0,ITF,ITF2,14,Molise
2021-04-11,BAS,848,330,518,786,62,ITF,ITF5,17,Basilicata
2021-04-22,EMR,28960,13403,15557,14936,14024,ITH,ITH5,8,Emilia-Romagna
2021-03-01,VEN,9388,3711,5677,7567,1821,ITH,ITH3,5,Veneto
2021-03-20,PIE,11916,4898,7018,6019,5897,ITC,ITC1,1,Piemonte
2021-04-22,SAR,10424,4614,5810,5508,4916,ITG,ITG2,20,Sardegna
2021-05-05,LAZ,46611,21395,25216,30888,15723,ITI,ITI4,12,Lazio
2021-01-03,MAR,896,348,548,896,0,ITI,ITI3,11,Marche
2021-01-04,MAR,1502,564,938,1502,0,ITI,ITI3,11,Marche
2021-02-12,ABR,1228,567,661,1039,189,ITF,ITF1,13,Abruzzo
2021-05-15,PUG,41992,18393,23599,23136,18856,ITF,ITF4,16,Puglia
2021-01-24,TOS,3349,1073,2276,201,3148,ITI,ITI1,9,Toscana
2021-04-17,LOM,48230,21204,27026,37462,10768,ITC,ITC4,3,Lombardia
2021-03-10,UMB,4012,1927,2085,2756,1256,ITI,ITI2,10,Umbria
2021-03-12,LOM,35236,12948,22288,25031,10205,ITC,ITC4,3,Lombardia
2021-03-18,CAL,4243,1978,2265,2275,1968,ITF,ITF6,18,Calabria
2021-04-04,EMR,9884,4718,5166,7615,2269,ITH,ITH5,8,Emilia-Romagna
2021-01-09,SAR,4026,1417,2609,4026,0,ITG,ITG2,20,Sardegna
2021-02-08,LOM,10079,2918,7161,2139,7940,ITC,ITC4,3,Lombardia
2021-01-15,LIG,2257,754,1503,2257,0,ITC,ITC3,7,Liguria
2021-04-12,CAM,23302,10918,12384,20265,3037,ITF,ITF3,15,Campania
2021-01-29,SAR,2952,1067,1885,48,2904,ITG,ITG2,20,Sardegna
2021-03-09,PIE,13962,5428,8534,11620,2342,ITC,ITC1,1,Piemonte
2021-04-22,LOM,73716,33310,40406,57451,16265,ITC,ITC4,3,Lombardia
2021-05-16,CAM,50977,23118,27859,33448,17529,ITF,ITF3,15,Campania
2020-12-27,CAM,720,422,298,720,0,ITF,ITF3,15,Campania
2021-02-21,MOL,573,227,346,571,2,ITF,ITF2,14,Molise
2021-03-15,MAR,4402,2027,2375,1312,3090,ITI,ITI3,11,Marche
2021-04-20,LAZ,30940,14198,16742,19666,11274,ITI,ITI4,12,Lazio
2021-01-28,SIC,9311,4392,4919,406,8905,ITG,ITG1,19,Sicilia
2021-02-20,FVG,2068,933,1135,1924,144,ITH,ITH4,6,Friuli-Venezia Giulia
2021-03-14,MOL,595,239,356,17,578,ITF,ITF2,14,Molise
2021-03-19,CAL,4178,1943,2235,1897,2281,ITF,ITF6,18,Calabria
2021-03-20,PUG,8241,3727,4514,3657,4584,ITF,ITF4,16,Puglia
2021-01-29,PIE,5943,1886,4057,455,5488,ITC,ITC1,1,Piemonte
2021-02-08,CAL,1847,733,1114,661,1186,ITF,ITF6,18,Calabria
2021-02-17,PIE,4792,2155,2637,3803,989,ITC,ITC1,1,Piemonte
2021-04-27,SAR,7598,3543,4055,5559,2039,ITG,ITG2,20,Sardegna
2021-01-14,VDA,237,69,168,237,0,ITC,ITC2,2,Valle d'Aosta / Vallée d'Aoste
2021-03-06,ABR,4176,1357,2819,3606,570,ITF,ITF1,13,Abruzzo
2021-03-16,SIC,9785,4365,5420,3667,6118,ITG,ITG1,19,Sicilia
2021-04-18,CAM,27213,13281,13932,18315,8898,ITF,ITF3,15,Campania
2021-01-24,LAZ,5694,2229,3465,612,5082,ITI,ITI4,12,Lazio
2021-03-08,CAL,5306,2807,2499,4248,1058,ITF,ITF6,18,Calabria
2021-03-25,TOS,23597,10119,13478,15273,8324,ITI,ITI1,9,Toscana
2021-01-27,PUG,4578,1928,2650,611,3967,ITF,ITF4,16,Puglia
2021-05-06,VDA,1063,509,554,679,384,ITC,ITC2,2,Valle d'Aosta / Vallée d'Aoste
2021-02-16,VEN,6637,2870,3767,6460,177,ITH,ITH3,5,Veneto
2021-02-22,VDA,316,94,222,213,103,ITC,ITC2,2,Valle d'Aosta / Vallée d'Aoste
2021-02-24,CAL,1844,940,904,1369,475,ITF,ITF6,18,Calabria
2021-04-24,MOL,2080,975,1105,607,1473,ITF,ITF2,14,Molise
2021-01-22,VEN,1080,332,748,25,1055,ITH,ITH3,5,Veneto
2021-01-28,LAZ,8276,3164,5112,780,7496,ITI,ITI4,12,Lazio
2021-03-21,BAS,1046,481,565,352,694,ITF,ITF5,17,Basilicata
2021-04-27,UMB,5643,2395,3248,3073,2570,ITI,ITI2,10,Umbria
2021-01-29,CAL,2045,984,1061,230,1815,ITF,ITF6,18,Calabria
2021-03-31,VEN,38515,16190,22325,31023,7492,ITH,ITH3,5,Veneto
2021-01-24,MAR,880,339,541,5,875,ITI,ITI3,11,Marche
2021-02-12,PAT,1010,340,670,589,421,ITH,ITH2,4,Provincia Autonoma Trento
2021-02-17,VEN,6022,2772,3250,5928,94,ITH,ITH3,5,Veneto
2021-03-12,FVG,3939,1544,2395,2558,1381,ITH,ITH4,6,Friuli-Venezia Giulia
2021-04-18,EMR,17443,8371,9072,12534,4909,ITH,ITH5,8,Emilia-Romagna
2021-01-22,CAL,658,274,384,656,2,ITF,ITF6,18,Calabria
2021-03-05,BAS,1851,855,996,1105,746,ITF,ITF5,17,Basilicata
2021-03-08,PIE,13925,5285,8640,11212,2713,ITC,ITC1,1,Piemonte
2021-03-10,LOM,33225,12725,20500,25371,7854,ITC,ITC4,3,Lombardia
2021-03-06,UMB,4267,1110,3157,4124,143,ITI,ITI2,10,Umbria
2021-03-31,CAL,8818,4006,4812,4882,3936,ITF,ITF6,18,Calabria
2021-04-07,LAZ,24959,11319,13640,17657,7302,ITI,ITI4,12,Lazio
2021-01-27,FVG,1272,425,847,450,822,ITH,ITH4,6,Friuli-Venezia Giulia
2021-03-04,VDA,291,139,152,42,249,ITC,ITC2,2,Valle d'Aosta / Vallée d'Aoste
2021-05-10,ABR,10134,4797,5337,5484,4650,ITF,ITF1,13,Abruzzo
2021-05-18,FVG,9731,4892,4839,8046,1685,ITH,ITH4,6,Friuli-Venezia Giulia
2021-02-05,VDA,294,102,192,101,193,ITC,ITC2,2,Valle d'Aosta / Vallée d'Aoste
2021-03-06,VEN,10634,4320,6314,7365,3269,ITH,ITH3,5,Veneto
2021-04-17,VEN,22348,9062,13286,15066,7282,ITH,ITH3,5,Veneto
2021-04-29,VDA,1291,634,657,757,534,ITC,ITC2,2,Valle d'Aosta / Vallée d'Aoste
2021-01-06,PAB,59,18,41,59,0,ITH,ITH1,4,Provincia Autonoma Bolzano / Bozen
2021-01-18,FVG,1960,606,1354,1866,94,ITH,ITH4,6,Friuli-Venezia Giulia
2021-01-30,LAZ,7009,2891,4118,807,6202,ITI,ITI4,12,Lazio
2021-04-16,VDA,599,261,338,597,2,ITC,ITC2,2,Valle d'Aosta / Vallée d'Aoste
2021-01-13,VDA,337,110,227,337,0,ITC,ITC2,2,Valle d'Aosta / Vallée d'Aoste
2021-02-16,UMB,1308,655,653,1299,9,ITI,ITI2,10,Umbria
2021-02-13,ABR,847,383,464,436,411,ITF,ITF1,13,Abruzzo
2021-02-13,FVG,567,179,388,561,6,ITH,ITH4,6,Friuli-Venezia Giulia
2021-02-26,BAS,2149,904,1245,2069,80,ITF,ITF5,17,Basilicata
2021-03-20,CAL,6452,2974,3478,4066,2386,ITF,ITF6,18,Calabria
2021-03-20,PAT,872,402,470,670,202,ITH,ITH2,4,Provincia Autonoma Trento
2021-03-22,TOS,4882,2443,2439,4438,444,ITI,ITI1,9,Toscana
2021-01-20,LIG,1550,555,995,1538,12,ITC,ITC3,7,Liguria
2021-03-27,PIE,18360,7817,10543,9546,8814,ITC,ITC1,1,Piemonte
2021-01-29,VEN,9016,2786,6230,367,8649,ITH,ITH3,5,Veneto
2021-03-01,SAR,2162,1055,1107,1503,659,ITG,ITG2,20,Sardegna
2021-05-15,PAT,1565,814,751,677,888,ITH,ITH2,4,Provincia Autonoma Trento
2021-01-27,CAL,1458,734,724,396,1062,ITF,ITF6,18,Calabria
2021-01-27,PAT,802,277,525,91,711,ITH,ITH2,4,Provincia Autonoma Trento
2021-03-01,PIE,12037,4844,7193,11228,809,ITC,ITC1,1,Piemonte
2021-03-10,EMR,18676,7650,11026,13036,5640,ITH,ITH5,8,Emilia-Romagna
2021-04-08,TOS,29641,12528,17113,23268,6373,ITI,ITI1,9,Toscana
2021-04-20,MAR,10699,4996,5703,9282,1417,ITI,ITI3,11,Marche
2021-04-24,UMB,4555,1961,2594,3381,1174,ITI,ITI2,10,Umbria
2021-01-14,TOS,3255,1179,2076,3255,0,ITI,ITI1,9,Toscana
2021-02-28,MOL,829,331,498,787,42,ITF,ITF2,14,Molise
2021-04-03,LIG,5406,2498,2908,4463,943,ITC,ITC3,7,Liguria
2021-04-03,PAB,831,364,467,22,809,ITH,ITH1,4,Provincia Autonoma Bolzano / Bozen
2021-05-06,TOS,31177,13544,17633,14116,17061,ITI,ITI1,9,Toscana
2021-01-25,BAS,1023,429,594,74,949,ITF,ITF5,17,Basilicata
2021-04-10,VDA,404,190,214,399,5,ITC,ITC2,2,Valle d'Aosta / Vallée d'Aoste
2021-04-20,SIC,19282,9083,10199,13942,5340,ITG,ITG1,19,Sicilia
2021-03-13,MAR,5762,2652,3110,1805,3957,ITI,ITI3,11,Marche
2021-03-15,LAZ,19280,8331,10949,12541,6739,ITI,ITI4,12,Lazio
2021-04-22,UMB,5420,2228,3192,2761,2659,ITI,ITI2,10,Umbria
2021-01-29,PAT,1352,331,1021,55,1297,ITH,ITH2,4,Provincia Autonoma Trento
2021-02-02,LIG,2668,1005,1663,134,2534,ITC,ITC3,7,Liguria
2021-03-10,SAR,6010,2917,3093,5160,850,ITG,ITG2,20,Sardegna
2021-03-18,ABR,3896,1651,2245,2065,1831,ITF,ITF1,13,Abruzzo
2021-04-19,VDA,751,325,426,542,209,ITC,ITC2,2,Valle d'Aosta / Vallée d'Aoste
2021-01-23,TOS,3949,1354,2595,640,3309,ITI,ITI1,9,Toscana
2021-03-18,PUG,9397,4251,5146,3281,6116,ITF,ITF4,16,Puglia
2021-04-12,BAS,2178,1056,1122,1679,499,ITF,ITF5,17,Basilicata
2021-04-15,PAT,3179,1437,1742,3027,152,ITH,ITH2,4,Provincia Autonoma Trento
2021-04-30,UMB,6219,2959,3260,2834,3385,ITI,ITI2,10,Umbria
2021-01-07,BAS,640,319,321,640,0,ITF,ITF5,17,Basilicata
2021-01-19,MAR,226,82,144,141,85,ITI,ITI3,11,Marche
2021-04-27,MOL,1590,765,825,462,1128,ITF,ITF2,14,Molise
2021-03-10,PAB,1261,524,737,1118,143,ITH,ITH1,4,Provincia Autonoma Bolzano / Bozen
2021-05-12,VDA,1137,549,588,467,670,ITC,ITC2,2,Valle d'Aosta / Vallée d'Aoste
2021-02-18,MOL,319,74,245,306,13,ITF,ITF2,14,Molise
2021-01-06,LIG,1660,616,1044,1660,0,ITC,ITC3,7,Liguria
2021-03-13,VDA,145,86,59,145,0,ITC,ITC2,2,Valle d'Aosta / Vallée d'Aoste
2021-05-05,SIC,26297,12173,14124,16707,9590,ITG,ITG1,19,Sicilia
2021-01-02,SIC,4878,2537,2341,4878,0,ITG,ITG1,19,Sicilia
2021-01-10,LIG,648,262,386,648,0,ITC,ITC3,7,Liguria
2021-05-13,PUG,37512,16733,20779,20861,16651,ITF,ITF4,16,Puglia
2021-05-18,PAT,3992,1880,2112,3197,795,ITH,ITH2,4,Provincia Autonoma Trento
2021-04-21,UMB,5298,2304,2994,3072,2226,ITI,ITI2,10,Umbria
2021-02-13,PUG,3726,1455,2271,3031,695,ITF,ITF4,16,Puglia
2021-03-03,VEN,12033,4591,7442,8539,3494,ITH,ITH3,5,Veneto
2021-01-26,MOL,450,184,266,8,442,ITF,ITF2,14,Molise
2021-02-17,UMB,1618,748,870,1267,351,ITI,ITI2,10,Umbria
2021-04-21,EMR,23844,10923,12921,14135,9709,ITH,ITH5,8,Emilia-Romagna
2021-04-28,SIC,29327,13761,15566,20256,9071,ITG,ITG1,19,Sicilia
2021-04-22,VEN,31858,13875,17983,16106,15752,ITH,ITH3,5,Veneto
2021-04-23,MAR,11156,5139,6017,8101,3055,ITI,ITI3,11,Marche
2021-02-01,FVG,2096,688,1408,16,2080,ITH,ITH4,6,Friuli-Venezia Giulia
2021-02-14,SIC,1058,403,655,918,140,ITG,ITG1,19,Sicilia
2021-03-21,ABR,2134,913,1221,843,1291,ITF,ITF1,13,Abruzzo
2021-05-07,VEN,47596,22841,24755,39028,8568,ITH,ITH3,5,Veneto
2021-05-16,CAL,13765,6718,7047,9960,3805,ITF,ITF6,18,Calabria
2021-05-18,CAL,15549,7776,7773,12080,3469,ITF,ITF6,18,Calabria
2021-02-23,BAS,1901,771,1130,1763,138,ITF,ITF5,17,Basilicata
2021-03-11,MAR,6595,2784,3811,5225,1370,ITI,ITI3,11,Marche
2021-05-16,PAT,1233,682,551,996,237,ITH,ITH2,4,Provincia Autonoma Trento
2021-05-03,SIC,23459,10821,12638,13573,9886,ITG,ITG1,19,Sicilia
2020-12-27,ABR,37,19,18,37,0,ITF,ITF1,13,Abruzzo
2021-01-06,EMR,8265,2943,5322,8265,0,ITH,ITH5,8,Emilia-Romagna
2021-01-11,LAZ,5529,2104,3425,5529,0,ITI,ITI4,12,Lazio
2021-01-21,PUG,2131,903,1228,1271,860,ITF,ITF4,16,Puglia
2021-02-09,SAR,2286,837,1449,1290,996,ITG,ITG2,20,Sardegna
2021-04-07,LIG,13585,6032,7553,11296,2289,ITC,ITC3,7,Liguria
2021-04-14,LAZ,29189,13234,15955,19071,10118,ITI,ITI4,12,Lazio
2021-04-24,CAL,18920,9442,9478,15527,3393,ITF,ITF6,18,Calabria
2021-01-31,EMR,7695,2761,4934,241,7454,ITH,ITH5,8,Emilia-Romagna
2021-02-15,TOS,8770,3375,5395,7945,825,ITI,ITI1,9,Toscana
2021-03-05,CAL,6135,3536,2599,5563,572,ITF,ITF6,18,Calabria
2021-03-14,EMR,8693,3744,4949,4897,3796,ITH,ITH5,8,Emilia-Romagna
2021-01-22,PUG,1409,578,831,991,418,ITF,ITF4,16,Puglia
2021-04-24,CAM,36291,17506,18785,25055,11236,ITF,ITF3,15,Campania
2021-05-02,VDA,765,345,420,605,160,ITC,ITC2,2,Valle d'Aosta / Vallée d'Aoste
2021-05-17,LOM,94018,45091,48927,29983,64035,ITC,ITC4,3,Lombardia
2021-01-28,LIG,2847,971,1876,39,2808,ITC,ITC3,7,Liguria
2021-03-19,TOS,10136,4457,5679,7271,2865,ITI,ITI1,9,Toscana
2021-03-04,TOS,17622,6757,10865,14540,3082,ITI,ITI1,9,Toscana
2021-04-03,UMB,2110,716,1394,1057,1053,ITI,ITI2,10,Umbria
2021-04-21,LOM,71563,32466,39097,56982,14581,ITC,ITC4,3,Lombardia
2021-02-16,CAM,5437,2411,3026,4666,771,ITF,ITF3,15,Campania
2021-04-14,TOS,20118,8313,11805,15026,5092,ITI,ITI1,9,Toscana
2021-03-11,SIC,15451,6518,8933,12886,2565,ITG,ITG1,19,Sicilia
2021-04-21,CAM,30205,14716,15489,17980,12225,ITF,ITF3,15,Campania
2021-05-01,SIC,24475,11328,13147,19315,5160,ITG,ITG1,19,Sicilia
2021-02-16,PIE,3966,1755,2211,3208,758,ITC,ITC1,1,Piemonte
2021-04-03,EMR,19929,8762,11167,16191,3738,ITH,ITH5,8,Emilia-Romagna
2021-04-18,LOM,36306,16194,20112,31080,5226,ITC,ITC4,3,Lombardia
2021-03-31,PIE,19105,8102,11003,10413,8692,ITC,ITC1,1,Piemonte
2021-05-13,PAT,3373,1567,1806,2294,1079,ITH,ITH2,4,Provincia Autonoma Trento
2021-02-02,SIC,5544,2624,2920,634,4910,ITG,ITG1,19,Sicilia
2021-02-10,PUG,3642,1435,2207,2132,1510,ITF,ITF4,16,Puglia
2021-01-25,CAM,5744,2926,2818,164,5580,ITF,ITF3,15,Campania
2021-03-27,VDA,333,164,169,302,31,ITC,ITC2,2,Valle d'Aosta / Vallée d'Aoste
2021-04-17,ABR,7345,3398,3947,4292,3053,ITF,ITF1,13,Abruzzo
2021-04-21,CAL,11475,5778,5697,8569,2906,ITF,ITF6,18,Calabria
2021-05-11,PIE,31789,15320,16469,18745,13044,ITC,ITC1,1,Piemonte
2021-03-08,PUG,14655,6082,8573,12258,2397,ITF,ITF4,16,Puglia
2021-03-17,LOM,26233,10482,15751,15244,10989,ITC,ITC4,3,Lombardia
2021-02-14,PIE,1476,498,978,876,600,ITC,ITC1,1,Piemonte
2021-02-17,LOM,11969,3746,8223,10580,1389,ITC,ITC4,3,Lombardia
2021-02-25,EMR,9228,3497,5731,8274,954,ITH,ITH5,8,Emilia-Romagna
2021-02-28,VEN,4136,1389,2747,3299,837,ITH,ITH3,5,Veneto
2021-05-17,CAL,15104,7544,7560,10381,4723,ITF,ITF6,18,Calabria
2021-01-26,VEN,6917,2091,4826,153,6764,ITH,ITH3,5,Veneto
2021-02-27,CAM,13950,4473,9477,12308,1642,ITF,ITF3,15,Campania
2021-03-07,LAZ,14094,5429,8665,10501,3593,ITI,ITI4,12,Lazio
2021-04-13,SAR,7603,3592,4011,5778,1825,ITG,ITG2,20,Sardegna
2021-04-19,TOS,9087,4502,4585,8060,1027,ITI,ITI1,9,Toscana
2021-02-18,CAM,9080,3812,5268,8372,708,ITF,ITF3,15,Campania
2021-02-28,CAL,2166,983,1183,2015,151,ITF,ITF6,18,Calabria
2021-04-13,EMR,23564,11035,12529,19279,4285,ITH,ITH5,8,Emilia-Romagna
2021-04-20,MOL,2311,1020,1291,1219,1092,ITF,ITF2,14,Molise
2021-05-07,ABR,12203,5708,6495,7771,4432,ITF,ITF1,13,Abruzzo
2021-02-04,VEN,7326,2017,5309,553,6773,ITH,ITH3,5,Veneto
2021-04-19,LAZ,30029,13645,16384,19388,10641,ITI,ITI4,12,Lazio
2020-12-27,LOM,717,413,304,717,0,ITC,ITC4,3,Lombardia
2021-01-09,PUG,4883,2248,2635,4883,0,ITF,ITF4,16,Puglia
2021-03-10,VEN,18930,8634,10296,13246,5684,ITH,ITH3,5,Veneto
2021-05-02,MAR,8899,3936,4963,3161,5738,ITI,ITI3,11,Marche
2021-05-07,PUG,48850,21783,27067,25764,23086,ITF,ITF4,16,Puglia
2021-03-29,PAT,2452,957,1495,1717,735,ITH,ITH2,4,Provincia Autonoma Trento
2021-05-08,PUG,53466,22606,30860,24024,29442,ITF,ITF4,16,Puglia
2021-02-05,MAR,2155,653,1502,440,1715,ITI,ITI3,11,Marche
2021-04-16,MAR,10084,4704,5380,9557,527,ITI,ITI3,11,Marche
2021-05-17,VEN,26200,12875,13325,16365,9835,ITH,ITH3,5,Veneto
2021-02-17,CAM,7388,3210,4178,6328,1060,ITF,ITF3,15,Campania
2021-03-08,FVG,4065,1594,2471,1977,2088,ITH,ITH4,6,Friuli-Venezia Giulia
2021-03-30,MAR,7418,3044,4374,4603,2815,ITI,ITI3,11,Marche
2021-04-28,MOL,1672,903,769,455,1217,ITF,ITF2,14,Molise
2021-04-29,TOS,39320,17703,21617,19219,20101,ITI,ITI1,9,Toscana
2021-05-13,TOS,34656,15209,19447,13685,20971,ITI,ITI1,9,Toscana
2021-05-17,PAB,3109,1499,1610,2425,684,ITH,ITH1,4,Provincia Autonoma Bolzano / Bozen
2021-02-21,SAR,1589,710,879,1559,30,ITG,ITG2,20,Sardegna
2021-03-01,ABR,3477,1385,2092,2724,753,ITF,ITF1,13,Abruzzo
2021-01-13,LAZ,5670,2145,3525,5670,0,ITI,ITI4,12,Lazio
2021-03-17,EMR,13714,5690,8024,5869,7845,ITH,ITH5,8,Emilia-Romagna
2021-04-18,CAL,5770,2759,3011,4891,879,ITF,ITF6,18,Calabria
2021-05-09,LIG,2820,1242,1578,1110,1710,ITC,ITC3,7,Liguria
2021-01-09,PIE,6184,2185,3999,6184,0,ITC,ITC1,1,Piemonte
2021-02-02,EMR,9479,3049,6430,526,8953,ITH,ITH5,8,Emilia-Romagna
2021-02-24,PIE,11407,4629,6778,10901,506,ITC,ITC1,1,Piemonte
2021-01-09,CAM,10567,5024,5543,10567,0,ITF,ITF3,15,Campania
2021-01-17,TOS,2535,871,1664,2022,513,ITI,ITI1,9,Toscana
2021-02-12,FVG,1193,428,765,1146,47,ITH,ITH4,6,Friuli-Venezia Giulia
2021-04-22,ABR,6664,3193,3471,4983,1681,ITF,ITF1,13,Abruzzo
2021-04-30,FVG,7276,3205,4071,3671,3605,ITH,ITH4,6,Friuli-Venezia Giulia
2021-05-14,PAB,5073,2281,2792,3058,2015,ITH,ITH1,4,Provincia Autonoma Bolzano / Bozen
2021-03-10,PAT,2409,927,1482,1488,921,ITH,ITH2,4,Provincia Autonoma Trento
2021-05-05,MOL,1545,677,868,1413,132,ITF,ITF2,14,Molise
2021-01-31,SAR,2121,750,1371,48,2073,ITG,ITG2,20,Sardegna
2021-03-08,ABR,5123,1666,3457,4151,972,ITF,ITF1,13,Abruzzo
2021-01-21,CAL,960,445,515,930,30,ITF,ITF6,18,Calabria
2021-04-15,FVG,6484,2858,3626,5214,1270,ITH,ITH4,6,Friuli-Venezia Giulia
2021-05-07,PAT,5964,3065,2899,5131,833,ITH,ITH2,4,Provincia Autonoma Trento
2021-02-15,PUG,3252,1268,1984,2632,620,ITF,ITF4,16,Puglia
2021-04-14,VDA,941,430,511,717,224,ITC,ITC2,2,Valle d'Aosta / Vallée d'Aoste
2021-01-09,PAT,190,40,150,190,0,ITH,ITH2,4,Provincia Autonoma Trento
2021-04-19,MAR,9602,4497,5105,8022,1580,ITI,ITI3,11,Marche
2021-01-07,PIE,5387,1739,3648,5387,0,ITC,ITC1,1,Piemonte
2021-03-28,TOS,6199,2801,3398,5945,254,ITI,ITI1,9,Toscana
2021-03-14,CAL,2542,1018,1524,2142,400,ITF,ITF6,18,Calabria
2021-03-31,ABR,6648,2878,3770,4581,2067,ITF,ITF1,13,Abruzzo
2021-04-15,VDA,810,377,433,671,139,ITC,ITC2,2,Valle d'Aosta / Vallée d'Aoste
2021-01-11,PAB,1569,513,1056,1569,0,ITH,ITH1,4,Provincia Autonoma Bolzano / Bozen
2021-02-09,VEN,5246,1890,3356,3446,1800,ITH,ITH3,5,Veneto
2021-03-03,BAS,1743,813,930,1186,557,ITF,ITF5,17,Basilicata
2021-05-19,LAZ,36168,16551,19617,28557,7611,ITI,ITI4,12,Lazio
2021-03-29,PUG,12846,5991,6855,6124,6722,ITF,ITF4,16,Puglia
2020-12-28,SIC,208,125,83,208,0,ITG,ITG1,19,Sicilia
2021-01-02,LIG,691,245,446,691,0,ITC,ITC3,7,Liguria
2021-01-11,SIC,5909,2594,3315,5909,0,ITG,ITG1,19,Sicilia
2021-04-09,LIG,12405,5550,6855,10677,1728,ITC,ITC3,7,Liguria
2021-05-11,PUG,31786,13981,17805,13736,18050,ITF,ITF4,16,Puglia
2021-04-24,EMR,28564,13211,15353,14357,14207,ITH,ITH5,8,Emilia-Romagna
2021-05-04,FVG,9457,4266,5191,6129,3328,ITH,ITH4,6,Friuli-Venezia Giulia
2021-03-24,SIC,21143,9907,11236,15306,5837,ITG,ITG1,19,Sicilia
2021-05-05,LIG,13680,6124,7556,5269,8411,ITC,ITC3,7,Liguria
2021-03-03,ABR,4619,1878,2741,3713,906,ITF,ITF1,13,Abruzzo
2021-04-17,BAS,3460,1655,1805,2199,1261,ITF,ITF5,17,Basilicata
2021-01-02,PAB,91,48,43,91,0,ITH,ITH1,4,Provincia Autonoma Bolzano / Bozen
2021-03-15,MOL,832,338,494,587,245,ITF,ITF2,14,Molise
2021-03-19,PUG,7948,3645,4303,3405,4543,ITF,ITF4,16,Puglia
2021-04-09,PAB,2926,1292,1634,2196,730,ITH,ITH1,4,Provincia Autonoma Bolzano / Bozen
2021-01-13,MAR,2105,746,1359,2105,0,ITI,ITI3,11,Marche
2021-01-26,EMR,8334,3000,5334,215,8119,ITH,ITH5,8,Emilia-Romagna
2021-02-04,LOM,27654,8072,19582,1971,25683,ITC,ITC4,3,Lombardia
2021-01-11,LIG,2654,990,1664,2654,0,ITC,ITC3,7,Liguria
2021-02-14,PAB,297,130,167,297,0,ITH,ITH1,4,Provincia Autonoma Bolzano / Bozen
2021-04-04,BAS,610,225,385,197,413,ITF,ITF5,17,Basilicata
2021-04-17,PAT,2201,1119,1082,2144,57,ITH,ITH2,4,Provincia Autonoma Trento
2021-03-01,UMB,1503,774,729,1389,114,ITI,ITI2,10,Umbria
2021-01-31,VEN,4768,1563,3205,394,4374,ITH,ITH3,5,Veneto
2021-02-09,CAL,2145,904,1241,947,1198,ITF,ITF6,18,Calabria
2021-05-19,TOS,17561,8408,9153,12394,5167,ITI,ITI1,9,Toscana
2021-01-09,VEN,7927,2538,5389,7927,0,ITH,ITH3,5,Veneto
2021-05-07,CAL,15878,7482,8396,9681,6197,ITF,ITF6,18,Calabria
2021-02-24,PAT,1318,523,795,922,396,ITH,ITH2,4,Provincia Autonoma Trento
2021-03-07,VDA,64,30,34,11,53,ITC,ITC2,2,Valle d'Aosta / Vallée d'Aoste
2021-05-17,SAR,11565,5425,6140,8829,2736,ITG,ITG2,20,Sardegna
2021-02-06,MAR,2459,900,1559,522,1937,ITI,ITI3,11,Marche
2021-05-07,BAS,4632,2276,2356,3281,1351,ITF,ITF5,17,Basilicata
2021-01-09,CAL,1918,1037,881,1918,0,ITF,ITF6,18,Calabria
2021-01-22,PAT,1668,433,1235,329,1339,ITH,ITH2,4,Provincia Autonoma Trento
2021-03-17,VEN,14642,5991,8651,7848,6794,ITH,ITH3,5,Veneto
2021-04-13,VEN,14002,6314,7688,8519,5483,ITH,ITH3,5,Veneto
2021-01-08,CAM,10455,4968,5487,10455,0,ITF,ITF3,15,Campania
2021-05-17,PIE,30349,14248,16101,17545,12804,ITC,ITC1,1,Piemonte
2021-01-26,SAR,1336,453,883,27,1309,ITG,ITG2,20,Sardegna
2021-04-11,CAM,17523,8605,8918,15441,2082,ITF,ITF3,15,Campania
2021-04-26,TOS,10128,4929,5199,7584,2544,ITI,ITI1,9,Toscana
2021-02-04,EMR,9932,3203,6729,1251,8681,ITH,ITH5,8,Emilia-Romagna
2021-02-16,PAT,663,244,419,658,5,ITH,ITH2,4,Provincia Autonoma Trento
2021-02-19,MOL,169,93,76,167,2,ITF,ITF2,14,Molise
2021-02-21,VEN,4635,1209,3426,4630,5,ITH,ITH3,5,Veneto
2021-04-11,CAL,4084,1863,2221,2144,1940,ITF,ITF6,18,Calabria
2021-05-16,FVG,9885,4735,5150,8494,1391,ITH,ITH4,6,Friuli-Venezia Giulia
2020-12-30,PAB,388,182,206,388,0,ITH,ITH1,4,Provincia Autonoma Bolzano / Bozen
2021-01-15,SIC,5083,2233,2850,5083,0,ITG,ITG1,19,Sicilia
2021-03-06,BAS,1352,535,817,757,595,ITF,ITF5,17,Basilicata
2021-03-07,SIC,9270,3456,5814,8187,1083,ITG,ITG1,19,Sicilia
2021-01-22,BAS,67,24,43,67,0,ITF,ITF5,17,Basilicata
2021-04-22,BAS,5035,2345,2690,3433,1602,ITF,ITF5,17,Basilicata
2021-01-18,VDA,213,74,139,213,0,ITC,ITC2,2,Valle d'Aosta / Vallée d'Aoste
2021-01-28,MOL,613,217,396,17,596,ITF,ITF2,14,Molise
2021-02-23,ABR,2782,1275,1507,2771,11,ITF,ITF1,13,Abruzzo
2021-03-31,LOM,41880,16949,24931,26729,15151,ITC,ITC4,3,Lombardia
2021-03-10,ABR,4947,1638,3309,3990,957,ITF,ITF1,13,Abruzzo
2021-01-05,UMB,854,429,425,854,0,ITI,ITI2,10,Umbria
2021-03-14,VEN,15166,5935,9231,14272,894,ITH,ITH3,5,Veneto
2021-02-28,SAR,368,169,199,142,226,ITG,ITG2,20,Sardegna
2021-03-08,PAT,1398,433,965,1045,353,ITH,ITH2,4,Provincia Autonoma Trento
2021-02-15,BAS,621,232,389,580,41,ITF,ITF5,17,Basilicata
2021-05-13,SAR,10560,4873,5687,7630,2930,ITG,ITG2,20,Sardegna
2021-02-22,LAZ,11457,4990,6467,10955,502,ITI,ITI4,12,Lazio
2021-03-04,ABR,5935,2358,3577,5013,922,ITF,ITF1,13,Abruzzo
2021-03-13,PUG,10380,4097,6283,8649,1731,ITF,ITF4,16,Puglia
2021-04-01,UMB,4330,1792,2538,2323,2007,ITI,ITI2,10,Umbria
2021-02-08,PAB,2,1,1,1,1,ITH,ITH1,4,Provincia Autonoma Bolzano / Bozen
2021-05-14,SAR,13257,6036,7221,10286,2971,ITG,ITG2,20,Sardegna
2021-05-15,PIE,33430,15597,17833,19887,13543,ITC,ITC1,1,Piemonte
2021-03-03,CAL,4861,2650,2211,3800,1061,ITF,ITF6,18,Calabria
2021-04-19,LOM,60069,27331,32738,50664,9405,ITC,ITC4,3,Lombardia
2021-04-27,EMR,29818,13786,16032,17370,12448,ITH,ITH5,8,Emilia-Romagna
2021-01-14,PAB,1946,575,1371,1946,0,ITH,ITH1,4,Provincia Autonoma Bolzano / Bozen
2021-02-09,PIE,7351,2309,5042,722,6629,ITC,ITC1,1,Piemonte
2021-04-24,ABR,8711,3970,4741,7179,1532,ITF,ITF1,13,Abruzzo
2021-01-19,PUG,1221,452,769,1211,10,ITF,ITF4,16,Puglia
2021-02-07,VEN,2315,862,1453,714,1601,ITH,ITH3,5,Veneto
2021-03-18,VDA,136,43,93,99,37,ITC,ITC2,2,Valle d'Aosta / Vallée d'Aoste
2021-04-26,CAL,10254,5157,5097,7880,2374,ITF,ITF6,18,Calabria
2021-03-22,LAZ,21694,9063,12631,15033,6661,ITI,ITI4,12,Lazio
2021-05-04,TOS,18254,8187,10067,12826,5428,ITI,ITI1,9,Toscana
2021-01-23,PAT,577,334,243,388,189,ITH,ITH2,4,Provincia Autonoma Trento
2020-12-30,VEN,699,245,454,699,0,ITH,ITH3,5,Veneto
2021-02-24,LAZ,12049,5206,6843,11055,994,ITI,ITI4,12,Lazio
2021-02-26,PAT,1218,435,783,923,295,ITH,ITH2,4,Provincia Autonoma Trento
2021-04-17,CAL,10646,4994,5652,8932,1714,ITF,ITF6,18,Calabria
2021-02-28,SIC,7173,3068,4105,6544,629,ITG,ITG1,19,Sicilia
2021-03-29,PAB,1170,499,671,411,759,ITH,ITH1,4,Provincia Autonoma Bolzano / Bozen
2021-04-02,LAZ,28531,13369,15162,21206,7325,ITI,ITI4,12,Lazio
2021-04-06,CAL,7212,3243,3969,4132,3080,ITF,ITF6,18,Calabria
2021-01-17,SAR,860,277,583,859,1,ITG,ITG2,20,Sardegna
2021-03-10,MAR,5669,2401,3268,4532,1137,ITI,ITI3,11,Marche
2021-03-20,LAZ,18225,6810,11415,12341,5884,ITI,ITI4,12,Lazio
2021-04-19,ABR,6226,2856,3370,3855,2371,ITF,ITF1,13,Abruzzo
2021-03-17,PUG,10274,4683,5591,4171,6103,ITF,ITF4,16,Puglia
2021-03-26,SIC,17999,8365,9634,12468,5531,ITG,ITG1,19,Sicilia
2021-04-10,LAZ,23799,10311,13488,16624,7175,ITI,ITI4,12,Lazio
2021-05-15,BAS,6508,3331,3177,3943,2565,ITF,ITF5,17,Basilicata
2021-03-19,SAR,7265,3047,4218,5052,2213,ITG,ITG2,20,Sardegna
2021-03-20,UMB,2297,832,1465,2272,25,ITI,ITI2,10,Umbria
2021-04-02,TOS,31920,13518,18402,23901,8019,ITI,ITI1,9,Toscana
2021-02-11,SIC,5321,2097,3224,4858,463,ITG,ITG1,19,Sicilia
2021-03-16,LAZ,13536,5730,7806,7094,6442,ITI,ITI4,12,Lazio
2021-04-07,PAT,2592,1008,1584,1651,941,ITH,ITH2,4,Provincia Autonoma Trento
2021-04-08,PAT,3112,1293,1819,1994,1118,ITH,ITH2,4,Provincia Autonoma Trento
2021-04-10,FVG,4980,2159,2821,3758,1222,ITH,ITH4,6,Friuli-Venezia Giulia
2021-04-24,LOM,75582,33504,42078,54532,21050,ITC,ITC4,3,Lombardia
2020-12-30,LAZ,1630,629,1001,1630,0,ITI,ITI4,12,Lazio
2021-04-02,FVG,6567,2915,3652,4734,1833,ITH,ITH4,6,Friuli-Venezia Giulia
2021-04-26,LAZ,29120,13389,15731,19924,9196,ITI,ITI4,12,Lazio
2021-03-15,TOS,8356,3331,5025,3914,4442,ITI,ITI1,9,Toscana
2021-04-03,TOS,15011,6644,8367,13885,1126,ITI,ITI1,9,Toscana
2021-05-17,SIC,32031,15405,16626,19288,12743,ITG,ITG1,19,Sicilia
2021-01-27,PIE,4196,1453,2743,999,3197,ITC,ITC1,1,Piemonte
2021-02-04,CAL,3391,1623,1768,644,2747,ITF,ITF6,18,Calabria
2021-04-30,PIE,31599,14181,17418,18330,13269,ITC,ITC1,1,Piemonte
2021-02-18,TOS,8817,3285,5532,7923,894,ITI,ITI1,9,Toscana
2021-03-02,PUG,16299,6052,10247,15002,1297,ITF,ITF4,16,Puglia
2021-04-09,LAZ,27226,12231,14995,19009,8217,ITI,ITI4,12,Lazio
2021-03-15,PAB,1192,451,741,710,482,ITH,ITH1,4,Provincia Autonoma Bolzano / Bozen
2021-03-19,PAB,1906,773,1133,799,1107,ITH,ITH1,4,Provincia Autonoma Bolzano / Bozen
2021-04-18,ABR,5814,2727,3087,4872,942,ITF,ITF1,13,Abruzzo
2021-01-16,SAR,1492,525,967,1492,0,ITG,ITG2,20,Sardegna
2021-02-24,UMB,1520,565,955,1505,15,ITI,ITI2,10,Umbria
2021-01-14,LIG,2981,1055,1926,2981,0,ITC,ITC3,7,Liguria
2021-01-18,MAR,673,230,443,547,126,ITI,ITI3,11,Marche
2021-04-29,CAM,41272,20004,21268,24801,16471,ITF,ITF3,15,Campania
2021-02-06,CAL,2907,1338,1569,442,2465,ITF,ITF6,18,Calabria
2021-04-25,SAR,4441,2242,2199,3662,779,ITG,ITG2,20,Sardegna
2021-01-24,ABR,50,22,28,6,44,ITF,ITF1,13,Abruzzo
2021-02-27,MOL,1366,568,798,1347,19,ITF,ITF2,14,Molise
2021-01-04,VEN,6735,2033,4702,6735,0,ITH,ITH3,5,Veneto
2021-02-02,PAB,1745,506,1239,8,1737,ITH,ITH1,4,Provincia Autonoma Bolzano / Bozen
2021-03-10,MOL,1737,720,1017,1687,50,ITF,ITF2,14,Molise
2021-05-18,CAM,52101,23179,28922,32570,19531,ITF,ITF3,15,Campania
2021-03-01,FVG,2958,1041,1917,2906,52,ITH,ITH4,6,Friuli-Venezia Giulia
2021-01-02,VDA,6,5,1,6,0,ITC,ITC2,2,Valle d'Aosta / Vallée d'Aoste
2021-01-04,PUG,4504,2013,2491,4504,0,ITF,ITF4,16,Puglia
2021-02-19,MAR,1962,712,1250,1827,135,ITI,ITI3,11,Marche
2021-03-13,SIC,12416,5475,6941,7833,4583,ITG,ITG1,19,Sicilia
2021-03-17,PAT,2067,790,1277,1199,868,ITH,ITH2,4,Provincia Autonoma Trento
2021-03-30,MOL,2003,857,1146,1491,512,ITF,ITF2,14,Molise
2021-04-07,PUG,15258,6751,8507,8591,6667,ITF,ITF4,16,Puglia
2021-04-26,SAR,6816,3262,3554,5941,875,ITG,ITG2,20,Sardegna
2021-05-10,TOS,26059,12312,13747,15475,10584,ITI,ITI1,9,Toscana
2021-05-14,UMB,5201,2420,2781,3398,1803,ITI,ITI2,10,Umbria
2021-05-18,VDA,967,483,484,352,615,ITC,ITC2,2,Valle d'Aosta / Vallée d'Aoste
2021-01-06,PIE,3116,1111,2005,3116,0,ITC,ITC1,1,Piemonte
2021-01-29,FVG,2414,814,1600,264,2150,ITH,ITH4,6,Friuli-Venezia Giulia
2021-03-13,BAS,1794,888,906,749,1045,ITF,ITF5,17,Basilicata
2021-04-01,SAR,10100,4026,6074,7087,3013,ITG,ITG2,20,Sardegna
2021-04-07,SIC,15554,7636,7918,8390,7164,ITG,ITG1,19,Sicilia
2021-05-03,MOL,1816,859,957,1684,132,ITF,ITF2,14,Molise
2021-05-12,SIC,36797,17329,19468,21862,14935,ITG,ITG1,19,Sicilia
2021-02-16,LIG,2397,954,1443,2004,393,ITC,ITC3,7,Liguria
2021-03-15,EMR,13237,6064,7173,6742,6495,ITH,ITH5,8,Emilia-Romagna
2021-04-16,CAL,10121,4950,5171,8525,1596,ITF,ITF6,18,Calabria
2021-05-08,LOM,86993,40442,46551,65641,21352,ITC,ITC4,3,Lombardia
2021-05-13,UMB,5867,2642,3225,3798,2069,ITI,ITI2,10,Umbria
2021-01-21,TOS,1589,686,903,867,722,ITI,ITI1,9,Toscana
2021-02-06,VDA,289,104,185,92,197,ITC,ITC2,2,Valle d'Aosta / Vallée d'Aoste
2021-02-18,MAR,2101,745,1356,1815,286,ITI,ITI3,11,Marche
2021-01-31,ABR,1501,487,1014,286,1215,ITF,ITF1,13,Abruzzo
2021-04-17,MOL,1690,825,865,962,728,ITF,ITF2,14,Molise
2021-03-02,PAT,1302,440,862,926,376,ITH,ITH2,4,Provincia Autonoma Trento
2021-03-22,FVG,3540,1343,2197,1586,1954,ITH,ITH4,6,Friuli-Venezia Giulia
2021-04-05,LOM,27388,11697,15691,19278,8110,ITC,ITC4,3,Lombardia
2021-04-06,SIC,17871,8542,9329,13546,4325,ITG,ITG1,19,Sicilia
2021-04-25,CAL,15815,8027,7788,14697,1118,ITF,ITF6,18,Calabria
2021-01-22,MOL,126,35,91,126,0,ITF,ITF2,14,Molise
2021-02-08,UMB,637,203,434,88,549,ITI,ITI2,10,Umbria
2021-05-11,CAM,39864,19243,20621,30497,9367,ITF,ITF3,15,Campania
2021-01-17,LAZ,4894,2028,2866,4682,212,ITI,ITI4,12,Lazio
2021-01-15,PAB,3282,1228,2054,3282,0,ITH,ITH1,4,Provincia Autonoma Bolzano / Bozen
2021-03-29,EMR,21173,9425,11748,16527,4646,ITH,ITH5,8,Emilia-Romagna
2021-01-31,LOM,9746,3763,5983,34,9712,ITC,ITC4,3,Lombardia
2021-02-05,CAL,3798,1709,2089,489,3309,ITF,ITF6,18,Calabria
2021-03-27,MAR,7377,3072,4305,5019,2358,ITI,ITI3,11,Marche
2021-01-16,SIC,2778,1196,1582,2778,0,ITG,ITG1,19,Sicilia
2021-02-04,SIC,6930,3186,3744,1455,5475,ITG,ITG1,19,Sicilia
2021-04-28,LAZ,32824,14984,17840,21280,11544,ITI,ITI4,12,Lazio
2021-05-13,LAZ,49334,22103,27231,31813,17521,ITI,ITI4,12,Lazio
2021-01-28,PUG,5471,2277,3194,472,4999,ITF,ITF4,16,Puglia
2021-02-27,VDA,231,85,146,124,107,ITC,ITC2,2,Valle d'Aosta / Vallée d'Aoste
2021-05-15,ABR,11339,5136,6203,6045,5294,ITF,ITF1,13,Abruzzo
2021-01-14,CAM,7073,2977,4096,7073,0,ITF,ITF3,15,Campania
2021-01-18,VEN,2763,777,1986,2564,199,ITH,ITH3,5,Veneto
2021-01-27,ABR,1364,515,849,39,1325,ITF,ITF1,13,Abruzzo
2021-02-10,MAR,1439,452,987,1080,359,ITI,ITI3,11,Marche
2021-01-09,LIG,1335,481,854,1335,0,ITC,ITC3,7,Liguria
2021-02-09,BAS,491,213,278,316,175,ITF,ITF5,17,Basilicata
2020-12-29,LAZ,488,176,312,488,0,ITI,ITI4,12,Lazio
2021-01-10,EMR,7130,2665,4465,7130,0,ITH,ITH5,8,Emilia-Romagna
2021-03-09,ABR,5168,1795,3373,4229,939,ITF,ITF1,13,Abruzzo
2021-03-13,PAT,830,380,450,782,48,ITH,ITH2,4,Provincia Autonoma Trento
2021-03-25,BAS,1880,601,1279,1534,346,ITF,ITF5,17,Basilicata
2021-05-05,VDA,1036,565,471,456,580,ITC,ITC2,2,Valle d'Aosta / Vallée d'Aoste
2021-05-06,CAM,57237,27882,29355,42797,14440,ITF,ITF3,15,Campania
2021-01-17,CAL,867,418,449,801,66,ITF,ITF6,18,Calabria
2021-04-11,PUG,16433,7235,9198,14777,1656,ITF,ITF4,16,Puglia
2020-12-31,VEN,3219,1042,2177,3219,0,ITH,ITH3,5,Veneto
2021-05-12,PAT,3282,1485,1797,2100,1182,ITH,ITH2,4,Provincia Autonoma Trento
2021-01-09,PAB,612,326,286,612,0,ITH,ITH1,4,Provincia Autonoma Bolzano / Bozen
2021-02-27,CAL,3668,1905,1763,3290,378,ITF,ITF6,18,Calabria
2021-03-20,SAR,5193,2073,3120,2916,2277,ITG,ITG2,20,Sardegna
2021-04-06,SAR,7445,3113,4332,5018,2427,ITG,ITG2,20,Sardegna
2021-04-05,VEN,19135,8367,10768,13695,5440,ITH,ITH3,5,Veneto
2021-02-03,PUG,5034,2004,3030,730,4304,ITF,ITF4,16,Puglia
2021-03-16,BAS,1900,799,1101,228,1672,ITF,ITF5,17,Basilicata
2021-04-04,SIC,6831,3329,3502,5539,1292,ITG,ITG1,19,Sicilia
2021-01-22,VDA,56,21,35,20,36,ITC,ITC2,2,Valle d'Aosta / Vallée d'Aoste
2021-01-23,PUG,3040,1294,1746,886,2154,ITF,ITF4,16,Puglia
2021-02-26,PUG,13707,5024,8683,12676,1031,ITF,ITF4,16,Puglia
2021-05-05,CAL,13576,6505,7071,8472,5104,ITF,ITF6,18,Calabria
2021-01-23,SIC,4218,2174,2044,217,4001,ITG,ITG1,19,Sicilia
2021-02-01,VEN,8557,2500,6057,161,8396,ITH,ITH3,5,Veneto
2021-02-01,LOM,16055,5316,10739,305,15750,ITC,ITC4,3,Lombardia
2021-02-25,CAM,12425,4478,7947,11237,1188,ITF,ITF3,15,Campania
2021-03-31,FVG,8030,3500,4530,7185,845,ITH,ITH4,6,Friuli-Venezia Giulia
2021-04-13,MOL,1615,710,905,1028,587,ITF,ITF2,14,Molise
2021-01-12,EMR,9410,3111,6299,9410,0,ITH,ITH5,8,Emilia-Romagna
2021-01-19,VEN,1309,472,837,1159,150,ITH,ITH3,5,Veneto
2021-02-24,SAR,2412,1293,1119,2223,189,ITG,ITG2,20,Sardegna
2021-03-27,TOS,8845,4139,4706,8630,215,ITI,ITI1,9,Toscana
2021-04-17,MAR,11699,5316,6383,10625,1074,ITI,ITI3,11,Marche
2021-01-09,BAS,557,160,397,557,0,ITF,ITF5,17,Basilicata
2021-01-31,MAR,1920,770,1150,105,1815,ITI,ITI3,11,Marche
2021-05-19,SAR,9269,4610,4659,6833,2436,ITG,ITG2,20,Sardegna
2021-02-15,PIE,4431,1596,2835,3226,1205,ITC,ITC1,1,Piemonte
2021-01-16,UMB,221,73,148,221,0,ITI,ITI2,10,Umbria
2021-03-03,LIG,4582,1847,2735,3556,1026,ITC,ITC3,7,Liguria
2021-04-08,PUG,17417,7560,9857,11245,6172,ITF,ITF4,16,Puglia
2021-01-15,TOS,3878,1347,2531,3878,0,ITI,ITI1,9,Toscana
2021-03-12,VEN,18556,8116,10440,11810,6746,ITH,ITH3,5,Veneto
2021-03-23,ABR,4782,2143,2639,2216,2566,ITF,ITF1,13,Abruzzo
2021-01-14,MAR,2010,692,1318,2010,0,ITI,ITI3,11,Marche
2021-03-28,SAR,4619,1814,2805,4540,79,ITG,ITG2,20,Sardegna
2021-01-15,UMB,701,215,486,701,0,ITI,ITI2,10,Umbria
2021-02-03,LOM,25577,7908,17669,1153,24424,ITC,ITC4,3,Lombardia
2021-02-26,EMR,7865,2995,4870,6819,1046,ITH,ITH5,8,Emilia-Romagna
2021-03-11,VDA,197,76,121,66,131,ITC,ITC2,2,Valle d'Aosta / Vallée d'Aoste
2021-04-09,SAR,12193,5403,6790,7842,4351,ITG,ITG2,20,Sardegna
2021-04-24,PAB,5101,2448,2653,4617,484,ITH,ITH1,4,Provincia Autonoma Bolzano / Bozen
2021-05-01,LAZ,37886,17053,20833,25949,11937,ITI,ITI4,12,Lazio
2020-12-30,MAR,17,5,12,17,0,ITI,ITI3,11,Marche
2021-03-28,LAZ,18838,7542,11296,13528,5310,ITI,ITI4,12,Lazio
2021-04-24,LIG,8169,3785,4384,5017,3152,ITC,ITC3,7,Liguria
2021-01-21,VEN,2291,719,1572,21,2270,ITH,ITH3,5,Veneto
2021-03-04,CAL,5378,3103,2275,4584,794,ITF,ITF6,18,Calabria
2021-03-05,PAB,1839,625,1214,1397,442,ITH,ITH1,4,Provincia Autonoma Bolzano / Bozen
2021-03-20,TOS,6489,2882,3607,5354,1135,ITI,ITI1,9,Toscana
2021-03-30,VEN,35864,15219,20645,30615,5249,ITH,ITH3,5,Veneto
2021-01-08,PAT,1449,313,1136,1449,0,ITH,ITH2,4,Provincia Autonoma Trento
2021-03-22,MOL,1146,439,707,903,243,ITF,ITF2,14,Molise
2021-02-22,FVG,2484,1193,1291,2067,417,ITH,ITH4,6,Friuli-Venezia Giulia
2021-03-05,SAR,5034,2444,2590,2681,2353,ITG,ITG2,20,Sardegna
2021-01-31,CAL,1107,555,552,154,953,ITF,ITF6,18,Calabria
2021-02-20,MAR,4121,1705,2416,4010,111,ITI,ITI3,11,Marche
2021-01-05,BAS,946,409,537,946,0,ITF,ITF5,17,Basilicata
2021-01-20,BAS,84,22,62,84,0,ITF,ITF5,17,Basilicata
2021-02-05,MOL,593,269,324,55,538,ITF,ITF2,14,Molise
2021-04-11,PAT,2335,1133,1202,2244,91,ITH,ITH2,4,Provincia Autonoma Trento
2021-04-13,CAM,26599,12678,13921,21070,5529,ITF,ITF3,15,Campania
2021-01-04,ABR,1401,575,826,1401,0,ITF,ITF1,13,Abruzzo
2021-03-01,PAT,1237,454,783,942,295,ITH,ITH2,4,Provincia Autonoma Trento
2021-04-28,MAR,10731,4889,5842,6002,4729,ITI,ITI3,11,Marche
2021-05-17,FVG,7599,3549,4050,6177,1422,ITH,ITH4,6,Friuli-Venezia Giulia
2021-01-27,BAS,411,175,236,113,298,ITF,ITF5,17,Basilicata
2021-03-11,ABR,5419,2183,3236,4280,1139,ITF,ITF1,13,Abruzzo
2021-03-21,EMR,11916,5270,6646,7312,4604,ITH,ITH5,8,Emilia-Romagna
2021-03-28,CAL,2531,1171,1360,1401,1130,ITF,ITF6,18,Calabria
2021-04-09,MAR,9558,4189,5369,9357,201,ITI,ITI3,11,Marche
2021-04-18,LIG,2604,1161,1443,2135,469,ITC,ITC3,7,Liguria
2021-04-26,MAR,8980,3983,4997,5958,3022,ITI,ITI3,11,Marche
2021-04-20,PIE,25434,11648,13786,19103,6331,ITC,ITC1,1,Piemonte
2021-01-03,LOM,854,316,538,854,0,ITC,ITC4,3,Lombardia
2021-02-20,CAM,8573,3080,5493,8270,303,ITF,ITF3,15,Campania
2021-04-01,SIC,14398,6673,7725,9683,4715,ITG,ITG1,19,Sicilia
2021-02-24,TOS,10372,4467,5905,10171,201,ITI,ITI1,9,Toscana
2021-04-30,PAT,4902,2395,2507,4765,137,ITH,ITH2,4,Provincia Autonoma Trento
2021-01-13,EMR,9071,2940,6131,9071,0,ITH,ITH5,8,Emilia-Romagna
2021-02-28,FVG,2684,1002,1682,2290,394,ITH,ITH4,6,Friuli-Venezia Giulia
2021-03-10,VDA,438,183,255,225,213,ITC,ITC2,2,Valle d'Aosta / Vallée d'Aoste
2021-04-10,MOL,2562,1234,1328,2411,151,ITF,ITF2,14,Molise
2021-05-19,CAL,9273,4523,4750,5917,3356,ITF,ITF6,18,Calabria
2021-02-07,LAZ,4942,2023,2919,387,4555,ITI,ITI4,12,Lazio
2021-05-09,PIE,26977,12855,14122,13377,13600,ITC,ITC1,1,Piemonte
2021-01-03,VEN,5158,1563,3595,5158,0,ITH,ITH3,5,Veneto
2021-02-09,PAT,914,287,627,441,473,ITH,ITH2,4,Provincia Autonoma Trento
2021-02-15,SIC,3926,1818,2108,3361,565,ITG,ITG1,19,Sicilia
2021-03-09,BAS,1391,706,685,787,604,ITF,ITF5,17,Basilicata
2021-02-10,CAM,6904,3413,3491,6728,176,ITF,ITF3,15,Campania
2021-05-06,FVG,11647,5393,6254,7762,3885,ITH,ITH4,6,Friuli-Venezia Giulia
2020-12-31,PUG,1635,782,853,1635,0,ITF,ITF4,16,Puglia
2021-01-04,LOM,6077,2097,3980,6077,0,ITC,ITC4,3,Lombardia
2021-01-20,PIE,6615,2089,4526,5898,717,ITC,ITC1,1,Piemonte
2021-02-03,VEN,5937,1663,4274,480,5457,ITH,ITH3,5,Veneto
2021-02-12,CAL,1709,668,1041,943,766,ITF,ITF6,18,Calabria
2021-03-11,PIE,13759,5069,8690,10664,3095,ITC,ITC1,1,Piemonte
2021-01-11,SAR,1183,505,678,1183,0,ITG,ITG2,20,Sardegna
2021-02-19,SIC,5129,2732,2397,4564,565,ITG,ITG1,19,Sicilia
2021-03-20,MAR,4135,1740,2395,1049,3086,ITI,ITI3,11,Marche
2021-05-06,LIG,14407,6362,8045,6108,8299,ITC,ITC3,7,Liguria
2021-05-06,PAB,5181,2747,2434,2612,2569,ITH,ITH1,4,Provincia Autonoma Bolzano / Bozen
2021-05-16,SAR,8001,3745,4256,5842,2159,ITG,ITG2,20,Sardegna
2021-01-18,PUG,1845,770,1075,1496,349,ITF,ITF4,16,Puglia
2021-02-06,EMR,7599,2405,5194,2130,5469,ITH,ITH5,8,Emilia-Romagna
2021-03-16,MOL,614,230,384,267,347,ITF,ITF2,14,Molise
2021-04-28,CAL,12453,6018,6435,9660,2793,ITF,ITF6,18,Calabria
2021-05-08,CAL,18136,8266,9870,10449,7687,ITF,ITF6,18,Calabria
2021-01-28,LOM,12194,3693,8501,780,11414,ITC,ITC4,3,Lombardia
2021-02-17,TOS,8175,3169,5006,7423,752,ITI,ITI1,9,Toscana
2021-05-18,LOM,86999,41681,45318,32249,54750,ITC,ITC4,3,Lombardia
2021-01-06,PUG,3945,1668,2277,3945,0,ITF,ITF4,16,Puglia
2021-01-25,SAR,588,212,376,22,566,ITG,ITG2,20,Sardegna
2021-02-20,VDA,251,210,41,241,10,ITC,ITC2,2,Valle d'Aosta / Vallée d'Aoste
2021-02-25,FVG,3159,1650,1509,3134,25,ITH,ITH4,6,Friuli-Venezia Giulia
2021-03-23,BAS,1588,612,976,1409,179,ITF,ITF5,17,Basilicata
2021-01-09,UMB,1745,499,1246,1745,0,ITI,ITI2,10,Umbria
2021-03-14,CAM,8502,3721,4781,4363,4139,ITF,ITF3,15,Campania
2021-04-18,PAB,3110,1607,1503,2100,1010,ITH,ITH1,4,Provincia Autonoma Bolzano / Bozen
2021-02-08,LAZ,9739,4153,5586,4508,5231,ITI,ITI4,12,Lazio
2021-01-02,BAS,949,380,569,949,0,ITF,ITF5,17,Basilicata
2021-02-18,SIC,5475,3153,2322,5047,428,ITG,ITG1,19,Sicilia
2021-04-22,PAT,3130,1461,1669,3086,44,ITH,ITH2,4,Provincia Autonoma Trento
2021-03-27,SIC,15749,7436,8313,10836,4913,ITG,ITG1,19,Sicilia
2021-04-23,EMR,29518,13793,15725,14668,14850,ITH,ITH5,8,Emilia-Romagna
2021-03-06,PAT,773,277,496,622,151,ITH,ITH2,4,Provincia Autonoma Trento
2021-04-09,TOS,24514,10538,13976,21111,3403,ITI,ITI1,9,Toscana
2021-04-12,SAR,6990,3179,3811,5276,1714,ITG,ITG2,20,Sardegna
2021-01-05,PIE,5381,1603,3778,5381,0,ITC,ITC1,1,Piemonte
2021-02-24,MAR,3486,1515,1971,3408,78,ITI,ITI3,11,Marche
2021-04-08,VDA,584,282,302,441,143,ITC,ITC2,2,Valle d'Aosta / Vallée d'Aoste
2021-05-03,CAM,40736,19878,20858,28893,11843,ITF,ITF3,15,Campania
2021-05-10,PIE,28455,13656,14799,15467,12988,ITC,ITC1,1,Piemonte
2021-01-09,LAZ,6294,2561,3733,6294,0,ITI,ITI4,12,Lazio
2020-12-31,PAT,1624,449,1175,1624,0,ITH,ITH2,4,Provincia Autonoma Trento
2021-01-30,VEN,8746,2672,6074,693,8053,ITH,ITH3,5,Veneto
2021-02-14,CAM,3928,1923,2005,3894,34,ITF,ITF3,15,Campania
2021-02-23,TOS,7721,3324,4397,7560,161,ITI,ITI1,9,Toscana
2021-03-21,PAB,768,285,483,14,754,ITH,ITH1,4,Provincia Autonoma Bolzano / Bozen
2021-01-11,VDA,325,112,213,325,0,ITC,ITC2,2,Valle d'Aosta / Vallée d'Aoste
2021-03-02,VDA,339,166,173,336,3,ITC,ITC2,2,Valle d'Aosta / Vallée d'Aoste
2021-04-02,PIE,20129,8298,11831,11702,8427,ITC,ITC1,1,Piemonte
2021-05-04,VEN,42573,20163,22410,34604,7969,ITH,ITH3,5,Veneto
2021-01-17,MAR,1606,687,919,1550,56,ITI,ITI3,11,Marche
2021-03-29,LAZ,23946,10754,13192,16915,7031,ITI,ITI4,12,Lazio
2021-05-06,UMB,9432,4301,5131,6135,3297,ITI,ITI2,10,Umbria
2021-01-14,UMB,752,201,551,752,0,ITI,ITI2,10,Umbria
2021-01-18,PAT,643,154,489,588,55,ITH,ITH2,4,Provincia Autonoma Trento
2021-01-20,VDA,23,8,15,23,0,ITC,ITC2,2,Valle d'Aosta / Vallée d'Aoste
2021-04-15,CAL,7392,3626,3766,5785,1607,ITF,ITF6,18,Calabria
2021-01-20,ABR,447,156,291,445,2,ITF,ITF1,13,Abruzzo
2021-05-04,SIC,26824,12464,14360,17637,9187,ITG,ITG1,19,Sicilia
2021-01-13,PAB,1691,557,1134,1691,0,ITH,ITH1,4,Provincia Autonoma Bolzano / Bozen
2021-01-31,LIG,624,270,354,9,615,ITC,ITC3,7,Liguria
2021-04-16,EMR,28755,13533,15222,19945,8810,ITH,ITH5,8,Emilia-Romagna
2021-04-18,UMB,1529,680,849,599,930,ITI,ITI2,10,Umbria
2021-05-10,BAS,4778,2369,2409,2739,2039,ITF,ITF5,17,Basilicata
2021-03-05,UMB,4591,1379,3212,3935,656,ITI,ITI2,10,Umbria
2021-04-11,SAR,5393,2442,2951,4273,1120,ITG,ITG2,20,Sardegna
2021-04-22,PUG,22771,10401,12370,17906,4865,ITF,ITF4,16,Puglia
2021-01-06,PAT,42,13,29,42,0,ITH,ITH2,4,Provincia Autonoma Trento
2021-02-21,FVG,800,281,519,423,377,ITH,ITH4,6,Friuli-Venezia Giulia
2021-03-08,SAR,4006,1788,2218,2786,1220,ITG,ITG2,20,Sardegna
2021-04-05,MAR,5688,2355,3333,4419,1269,ITI,ITI3,11,Marche
2021-02-13,CAL,1329,583,746,966,363,ITF,ITF6,18,Calabria
2021-02-18,CAL,1805,805,1000,1580,225,ITF,ITF6,18,Calabria
2021-03-06,PUG,15919,5950,9969,13850,2069,ITF,ITF4,16,Puglia
2021-03-27,PUG,12118,5689,6429,6963,5155,ITF,ITF4,16,Puglia
2021-04-29,FVG,6656,2922,3734,4136,2520,ITH,ITH4,6,Friuli-Venezia Giulia
2021-05-18,LIG,13196,5976,7220,9945,3251,ITC,ITC3,7,Liguria
2020-12-28,LAZ,959,412,547,959,0,ITI,ITI4,12,Lazio
2021-03-29,UMB,3799,1648,2151,2320,1479,ITI,ITI2,10,Umbria
2021-01-15,SAR,1563,573,990,1563,0,ITG,ITG2,20,Sardegna
2021-02-12,SAR,2237,933,1304,2178,59,ITG,ITG2,20,Sardegna
2021-04-29,LIG,15546,6971,8575,6727,8819,ITC,ITC3,7,Liguria
2021-01-18,SIC,1642,662,980,1495,147,ITG,ITG1,19,Sicilia
2021-05-05,EMR,29331,13643,15688,18112,11219,ITH,ITH5,8,Emilia-Romagna
2021-01-08,PUG,5588,2343,3245,5588,0,ITF,ITF4,16,Puglia
2021-03-17,MOL,908,385,523,576,332,ITF,ITF2,14,Molise
2021-01-25,CAL,1065,512,553,148,917,ITF,ITF6,18,Calabria
2021-04-03,SIC,16233,7732,8501,13397,2836,ITG,ITG1,19,Sicilia
2021-04-30,SAR,10735,5113,5622,6676,4059,ITG,ITG2,20,Sardegna
2021-05-01,EMR,28371,12760,15611,15603,12768,ITH,ITH5,8,Emilia-Romagna
2021-02-19,CAL,1462,652,810,1201,261,ITF,ITF6,18,Calabria
2021-03-07,TOS,5647,2356,3291,2105,3542,ITI,ITI1,9,Toscana
2021-02-10,LIG,2312,837,1475,1020,1292,ITC,ITC3,7,Liguria
2021-02-21,SIC,5168,2501,2667,5061,107,ITG,ITG1,19,Sicilia
2021-03-01,PUG,15071,5850,9221,13701,1370,ITF,ITF4,16,Puglia
2021-04-17,VDA,638,407,231,636,2,ITC,ITC2,2,Valle d'Aosta / Vallée d'Aoste
2021-02-25,LOM,15198,6303,8895,13645,1553,ITC,ITC4,3,Lombardia
2021-05-08,ABR,10287,4868,5419,6451,3836,ITF,ITF1,13,Abruzzo
2021-02-05,EMR,9314,2966,6348,1637,7677,ITH,ITH5,8,Emilia-Romagna
2021-02-01,ABR,1632,573,1059,271,1361,ITF,ITF1,13,Abruzzo
2021-02-15,PAT,533,187,346,419,114,ITH,ITH2,4,Provincia Autonoma Trento
2021-04-12,CAL,6690,3265,3425,5092,1598,ITF,ITF6,18,Calabria
2021-04-27,CAM,32084,15582,16502,24171,7913,ITF,ITF3,15,Campania
2021-05-02,SAR,5857,2655,3202,5275,582,ITG,ITG2,20,Sardegna
2021-01-19,LOM,8125,2348,5777,7651,474,ITC,ITC4,3,Lombardia
2021-02-09,PUG,3840,1570,2270,2168,1672,ITF,ITF4,16,Puglia
2021-05-13,MAR,12601,5693,6908,7105,5496,ITI,ITI3,11,Marche
2021-03-02,MAR,4956,1943,3013,4390,566,ITI,ITI3,11,Marche
2021-01-05,LAZ,7373,2802,4571,7373,0,ITI,ITI4,12,Lazio
2021-02-14,LOM,3578,1546,2032,2944,634,ITC,ITC4,3,Lombardia
2021-04-30,PUG,34325,15333,18992,22471,11854,ITF,ITF4,16,Puglia
2021-02-27,LOM,13949,5871,8078,13307,642,ITC,ITC4,3,Lombardia
2020-12-27,BAS,106,41,65,106,0,ITF,ITF5,17,Basilicata
2021-02-02,UMB,944,274,670,32,912,ITI,ITI2,10,Umbria
2021-05-01,BAS,4699,2135,2564,3948,751,ITF,ITF5,17,Basilicata
2021-03-10,CAL,6414,3260,3154,5225,1189,ITF,ITF6,18,Calabria
2021-03-18,LOM,27425,10957,16468,16196,11229,ITC,ITC4,3,Lombardia
2021-01-11,CAL,2155,1041,1114,2155,0,ITF,ITF6,18,Calabria
2021-01-13,TOS,4062,1398,2664,4062,0,ITI,ITI1,9,Toscana
2021-03-15,UMB,4596,1930,2666,2828,1768,ITI,ITI2,10,Umbria
2021-04-20,BAS,4037,1923,2114,2206,1831,ITF,ITF5,17,Basilicata
2021-01-26,CAM,7340,3726,3614,351,6989,ITF,ITF3,15,Campania
2021-03-19,LAZ,17219,7365,9854,10892,6327,ITI,ITI4,12,Lazio
2021-04-05,ABR,2693,1147,1546,1813,880,ITF,ITF1,13,Abruzzo
2021-01-04,CAL,1051,517,534,1051,0,ITF,ITF6,18,Calabria
2021-03-07,UMB,845,180,665,838,7,ITI,ITI2,10,Umbria
2021-04-11,MAR,7116,3115,4001,6830,286,ITI,ITI3,11,Marche
2021-03-23,EMR,18692,8064,10628,12006,6686,ITH,ITH5,8,Emilia-Romagna
2021-04-20,PAT,2860,1369,1491,2824,36,ITH,ITH2,4,Provincia Autonoma Trento
2021-05-02,BAS,4182,2000,2182,3554,628,ITF,ITF5,17,Basilicata
2021-02-10,UMB,715,349,366,700,15,ITI,ITI2,10,Umbria
2021-04-07,ABR,7120,3283,3837,4394,2726,ITF,ITF1,13,Abruzzo
2021-01-14,SAR,1105,426,679,1105,0,ITG,ITG2,20,Sardegna
2021-02-06,CAM,5340,2665,2675,2102,3238,ITF,ITF3,15,Campania
2021-03-26,PAT,3151,1226,1925,2552,599,ITH,ITH2,4,Provincia Autonoma Trento
2021-04-23,CAM,32288,15504,16784,23154,9134,ITF,ITF3,15,Campania
2021-01-24,EMR,2443,885,1558,299,2144,ITH,ITH5,8,Emilia-Romagna
2021-04-02,EMR,23269,10478,12791,18812,4457,ITH,ITH5,8,Emilia-Romagna
2021-01-03,ABR,471,185,286,471,0,ITF,ITF1,13,Abruzzo
2021-01-09,MAR,1709,605,1104,1709,0,ITI,ITI3,11,Marche
2021-03-25,LOM,42532,15875,26657,30019,12513,ITC,ITC4,3,Lombardia
2021-01-23,SAR,60,22,38,0,60,ITG,ITG2,20,Sardegna
2021-02-16,TOS,9279,3339,5940,8558,721,ITI,ITI1,9,Toscana
2021-04-16,VEN,24416,10482,13934,12523,11893,ITH,ITH3,5,Veneto
2021-05-09,BAS,4675,2337,2338,2984,1691,ITF,ITF5,17,Basilicata
2021-03-15,ABR,3630,1395,2235,1822,1808,ITF,ITF1,13,Abruzzo
2021-04-30,VDA,831,355,476,485,346,ITC,ITC2,2,Valle d'Aosta / Vallée d'Aoste
2021-05-01,LOM,95708,43566,52142,66674,29034,ITC,ITC4,3,Lombardia
2021-01-13,UMB,450,139,311,450,0,ITI,ITI2,10,Umbria
2021-03-27,PAB,3047,1552,1495,1541,1506,ITH,ITH1,4,Provincia Autonoma Bolzano / Bozen
2021-03-28,MOL,1592,741,851,490,1102,ITF,ITF2,14,Molise
2021-04-07,UMB,5545,2283,3262,3540,2005,ITI,ITI2,10,Umbria
2021-04-11,VDA,479,208,271,479,0,ITC,ITC2,2,Valle d'Aosta / Vallée d'Aoste
2021-02-22,MOL,265,129,136,250,15,ITF,ITF2,14,Molise
2021-04-04,TOS,13910,6601,7309,13657,253,ITI,ITI1,9,Toscana
2021-01-10,CAM,8165,3736,4429,8165,0,ITF,ITF3,15,Campania
2021-02-13,VEN,3268,1475,1793,3248,20,ITH,ITH3,5,Veneto
2021-03-15,FVG,3764,1636,2128,1446,2318,ITH,ITH4,6,Friuli-Venezia Giulia
2021-02-12,MAR,1582,618,964,1430,152,ITI,ITI3,11,Marche
2021-04-09,PIE,25824,11378,14446,21316,4508,ITC,ITC1,1,Piemonte
2021-05-08,MOL,2945,1439,1506,1724,1221,ITF,ITF2,14,Molise
2021-04-27,FVG,8061,3695,4366,3604,4457,ITH,ITH4,6,Friuli-Venezia Giulia
2021-05-19,MOL,1751,892,859,1367,384,ITF,ITF2,14,Molise
2021-03-30,LOM,39457,15468,23989,24704,14753,ITC,ITC4,3,Lombardia
2021-04-14,UMB,8145,3672,4473,6166,1979,ITI,ITI2,10,Umbria
2021-05-03,LOM,83584,39702,43882,71482,12102,ITC,ITC4,3,Lombardia
2021-02-03,ABR,2061,717,1344,419,1642,ITF,ITF1,13,Abruzzo
2021-04-18,LAZ,23769,10556,13213,16135,7634,ITI,ITI4,12,Lazio
2021-02-12,SIC,4674,1847,2827,4407,267,ITG,ITG1,19,Sicilia
2021-02-07,LOM,7305,2819,4486,340,6965,ITC,ITC4,3,Lombardia
2021-02-09,VDA,251,84,167,68,183,ITC,ITC2,2,Valle d'Aosta / Vallée d'Aoste
2021-04-03,FVG,3983,1969,2014,2655,1328,ITH,ITH4,6,Friuli-Venezia Giulia
2020-12-31,FVG,1053,384,669,1053,0,ITH,ITH4,6,Friuli-Venezia Giulia
2021-01-27,SIC,7524,3835,3689,187,7337,ITG,ITG1,19,Sicilia
2021-02-17,VDA,327,144,183,227,100,ITC,ITC2,2,Valle d'Aosta / Vallée d'Aoste
2021-04-13,ABR,5880,2753,3127,4680,1200,ITF,ITF1,13,Abruzzo
2021-05-15,SIC,56888,26575,30313,41526,15362,ITG,ITG1,19,Sicilia
2021-02-27,LAZ,11428,4268,7160,10473,955,ITI,ITI4,12,Lazio
2021-03-06,VDA,22,4,18,22,0,ITC,ITC2,2,Valle d'Aosta / Vallée d'Aoste
2021-01-05,PAT,709,232,477,709,0,ITH,ITH2,4,Provincia Autonoma Trento
2021-01-24,VEN,4117,1219,2898,28,4089,ITH,ITH3,5,Veneto
2021-02-02,CAL,2287,1114,1173,177,2110,ITF,ITF6,18,Calabria
2021-03-02,CAL,4126,2385,1741,3417,709,ITF,ITF6,18,Calabria
2021-03-04,EMR,16416,5343,11073,13411,3005,ITH,ITH5,8,Emilia-Romagna
2021-05-01,VEN,38666,18155,20511,29753,8913,ITH,ITH3,5,Veneto
2021-04-26,MOL,1154,519,635,825,329,ITF,ITF2,14,Molise
2021-01-09,TOS,4485,1596,2889,4485,0,ITI,ITI1,9,Toscana
2021-01-12,SAR,865,408,457,865,0,ITG,ITG2,20,Sardegna
2021-03-01,TOS,4472,1733,2739,832,3640,ITI,ITI1,9,Toscana
2021-03-13,UMB,1731,524,1207,1486,245,ITI,ITI2,10,Umbria
2021-01-28,ABR,1433,495,938,12,1421,ITF,ITF1,13,Abruzzo
2021-01-31,PUG,1809,826,983,73,1736,ITF,ITF4,16,Puglia
2021-04-02,SIC,14007,6595,7412,9221,4786,ITG,ITG1,19,Sicilia
2021-04-09,ABR,8768,4128,4640,6229,2539,ITF,ITF1,13,Abruzzo
2021-02-01,MOL,562,201,361,14,548,ITF,ITF2,14,Molise
2021-02-08,MOL,334,141,193,216,118,ITF,ITF2,14,Molise
2021-03-22,EMR,17452,7645,9807,10589,6863,ITH,ITH5,8,Emilia-Romagna
2021-03-28,MAR,4126,1739,2387,2435,1691,ITI,ITI3,11,Marche
2021-01-04,FVG,1507,558,949,1507,0,ITH,ITH4,6,Friuli-Venezia Giulia
2021-01-15,BAS,813,350,463,813,0,ITF,ITF5,17,Basilicata
2021-04-18,TOS,8323,4079,4244,7328,995,ITI,ITI1,9,Toscana
2021-04-20,CAM,31984,15484,16500,20680,11304,ITF,ITF3,15,Campania
2021-03-21,LAZ,17862,6829,11033,12812,5050,ITI,ITI4,12,Lazio
2021-04-04,PUG,5938,2953,2985,5932,6,ITF,ITF4,16,Puglia
2021-04-10,EMR,20848,9262,11586,16720,4128,ITH,ITH5,8,Emilia-Romagna
2021-04-21,VDA,868,410,458,620,248,ITC,ITC2,2,Valle d'Aosta / Vallée d'Aoste
2021-05-05,CAM,51055,24809,26246,44685,6370,ITF,ITF3,15,Campania
2021-03-24,EMR,21050,9291,11759,13679,7371,ITH,ITH5,8,Emilia-Romagna
2021-01-18,UMB,614,219,395,529,85,ITI,ITI2,10,Umbria
2021-02-26,VDA,207,58,149,122,85,ITC,ITC2,2,Valle d'Aosta / Vallée d'Aoste
2021-03-30,PAB,1298,532,766,218,1080,ITH,ITH1,4,Provincia Autonoma Bolzano / Bozen
2021-04-11,SIC,15344,7578,7766,8315,7029,ITG,ITG1,19,Sicilia
2021-04-13,LOM,47565,21235,26330,33502,14063,ITC,ITC4,3,Lombardia
2021-04-21,MAR,10780,4967,5813,9586,1194,ITI,ITI3,11,Marche
2021-01-15,PIE,8970,2955,6015,8970,0,ITC,ITC1,1,Piemonte
2021-01-21,LIG,1102,385,717,672,430,ITC,ITC3,7,Liguria
2021-02-24,SIC,9562,4851,4711,8972,590,ITG,ITG1,19,Sicilia
2021-03-22,VEN,18089,8133,9956,13045,5044,ITH,ITH3,5,Veneto
2021-02-05,CAM,7261,3463,3798,2133,5128,ITF,ITF3,15,Campania
2021-05-07,MAR,12836,5804,7032,3659,9177,ITI,ITI3,11,Marche
2021-01-25,MAR,1595,558,1037,97,1498,ITI,ITI3,11,Marche
2021-04-06,LAZ,23874,10651,13223,16774,7100,ITI,ITI4,12,Lazio
2021-05-10,VDA,780,381,399,546,234,ITC,ITC2,2,Valle d'Aosta / Vallée d'Aoste
2021-02-07,FVG,1561,483,1078,386,1175,ITH,ITH4,6,Friuli-Venezia Giulia
2021-03-23,VEN,22145,10186,11959,17426,4719,ITH,ITH3,5,Veneto
2021-05-09,CAM,43170,20276,22894,32084,11086,ITF,ITF3,15,Campania
2021-04-12,MAR,8568,3772,4796,8084,484,ITI,ITI3,11,Marche
2021-01-26,LOM,8374,2719,5655,372,8002,ITC,ITC4,3,Lombardia
2021-02-06,VEN,4093,1353,2740,709,3384,ITH,ITH3,5,Veneto
2021-01-07,MAR,1806,636,1170,1806,0,ITI,ITI3,11,Marche
2021-03-07,SAR,1657,750,907,1117,540,ITG,ITG2,20,Sardegna
2021-04-05,FVG,2868,1425,1443,2853,15,ITH,ITH4,6,Friuli-Venezia Giulia
2021-05-13,MOL,3023,1406,1617,2577,446,ITF,ITF2,14,Molise
2021-01-05,CAM,7238,3637,3601,7238,0,ITF,ITF3,15,Campania
2021-01-19,ABR,111,55,56,91,20,ITF,ITF1,13,Abruzzo
2021-03-05,LAZ,18781,7951,10830,14049,4732,ITI,ITI4,12,Lazio
2021-03-15,CAL,3492,1664,1828,2065,1427,ITF,ITF6,18,Calabria
2021-03-19,MAR,3835,1597,2238,339,3496,ITI,ITI3,11,Marche
2021-04-25,CAM,30700,15166,15534,25311,5389,ITF,ITF3,15,Campania
2021-03-07,PAB,114,13,101,9,105,ITH,ITH1,4,Provincia Autonoma Bolzano / Bozen
2021-04-23,PAT,3584,1743,1841,3530,54,ITH,ITH2,4,Provincia Autonoma Trento
2021-02-25,PIE,12218,5252,6966,11671,547,ITC,ITC1,1,Piemonte
2021-03-24,VEN,22019,9504,12515,15211,6808,ITH,ITH3,5,Veneto
2021-04-07,PIE,23603,9992,13611,18139,5464,ITC,ITC1,1,Piemonte
2021-04-07,SAR,13474,5985,7489,7826,5648,ITG,ITG2,20,Sardegna
2021-02-23,VDA,216,123,93,216,0,ITC,ITC2,2,Valle d'Aosta / Vallée d'Aoste
2021-04-08,BAS,763,348,415,754,9,ITF,ITF5,17,Basilicata
2021-01-14,CAL,2557,1214,1343,2557,0,ITF,ITF6,18,Calabria
2021-02-13,SIC,3097,1164,1933,2841,256,ITG,ITG1,19,Sicilia
2021-03-11,BAS,1783,919,864,824,959,ITF,ITF5,17,Basilicata
2021-04-19,BAS,4160,1910,2250,2523,1637,ITF,ITF5,17,Basilicata
2021-05-10,SIC,28303,13596,14707,16189,12114,ITG,ITG1,19,Sicilia
2021-04-10,VEN,27413,11956,15457,18935,8478,ITH,ITH3,5,Veneto
2020-12-30,FVG,630,246,384,630,0,ITH,ITH4,6,Friuli-Venezia Giulia
2021-02-28,PUG,6010,1798,4212,5824,186,ITF,ITF4,16,Puglia
2021-03-09,SIC,13156,5589,7567,10784,2372,ITG,ITG1,19,Sicilia
2021-04-12,SIC,18947,9202,9745,11607,7340,ITG,ITG1,19,Sicilia
2021-02-13,EMR,3625,1085,2540,3027,598,ITH,ITH5,8,Emilia-Romagna
2021-03-02,SAR,2865,1459,1406,1712,1153,ITG,ITG2,20,Sardegna
2021-01-17,MOL,78,38,40,48,30,ITF,ITF2,14,Molise
2021-03-26,PUG,11440,5339,6101,6797,4643,ITF,ITF4,16,Puglia
2021-01-28,PIE,5590,1809,3781,384,5206,ITC,ITC1,1,Piemonte
2021-04-14,SAR,8232,3893,4339,6995,1237,ITG,ITG2,20,Sardegna
2021-04-19,MOL,1824,842,982,1047,777,ITF,ITF2,14,Molise
2020-12-28,LOM,107,47,60,107,0,ITC,ITC4,3,Lombardia
2021-05-10,MAR,9456,4340,5116,4895,4561,ITI,ITI3,11,Marche
2021-01-25,SIC,7508,3695,3813,315,7193,ITG,ITG1,19,Sicilia
2021-01-07,TOS,6018,1751,4267,6018,0,ITI,ITI1,9,Toscana
2021-01-11,PIE,8742,2980,5762,8742,0,ITC,ITC1,1,Piemonte
2021-03-31,TOS,32566,13128,19438,20411,12155,ITI,ITI1,9,Toscana
2021-05-02,PIE,25026,11250,13776,14282,10744,ITC,ITC1,1,Piemonte
2021-03-07,LOM,12019,5347,6672,9460,2559,ITC,ITC4,3,Lombardia
2021-03-19,MOL,1184,482,702,757,427,ITF,ITF2,14,Molise
2021-05-05,PAT,4968,2574,2394,4688,280,ITH,ITH2,4,Provincia Autonoma Trento
2021-03-17,VDA,433,185,248,273,160,ITC,ITC2,2,Valle d'Aosta / Vallée d'Aoste
2021-03-20,SIC,18814,9031,9783,13487,5327,ITG,ITG1,19,Sicilia
2021-04-02,VEN,23961,10547,13414,17631,6330,ITH,ITH3,5,Veneto
2021-04-09,CAL,7773,3649,4124,4856,2917,ITF,ITF6,18,Calabria
2021-01-30,CAM,10721,5079,5642,38,10683,ITF,ITF3,15,Campania
2021-02-11,SAR,1315,490,825,1204,111,ITG,ITG2,20,Sardegna
2021-05-04,LIG,13598,6081,7517,5371,8227,ITC,ITC3,7,Liguria
2021-01-11,BAS,183,66,117,183,0,ITF,ITF5,17,Basilicata
2021-02-06,PAT,574,298,276,433,141,ITH,ITH2,4,Provincia Autonoma Trento
2021-01-18,PAB,1772,687,1085,1767,5,ITH,ITH1,4,Provincia Autonoma Bolzano / Bozen
2021-01-28,BAS,903,401,502,119,784,ITF,ITF5,17,Basilicata
2021-02-02,PIE,10239,3508,6731,815,9424,ITC,ITC1,1,Piemonte
2021-02-04,LAZ,6301,2480,3821,989,5312,ITI,ITI4,12,Lazio
2021-01-22,LAZ,4002,1633,2369,487,3515,ITI,ITI4,12,Lazio
2021-04-14,PAB,3593,1645,1948,3501,92,ITH,ITH1,4,Provincia Autonoma Bolzano / Bozen
2021-01-19,FVG,6,2,4,6,0,ITH,ITH4,6,Friuli-Venezia Giulia
2021-02-15,UMB,1368,692,676,1367,1,ITI,ITI2,10,Umbria
2021-02-20,LIG,1336,637,699,1335,1,ITC,ITC3,7,Liguria
2021-04-05,CAL,3450,1629,1821,2553,897,ITF,ITF6,18,Calabria
2021-01-03,FVG,312,122,190,312,0,ITH,ITH4,6,Friuli-Venezia Giulia
2021-01-17,LOM,8342,3343,4999,8141,201,ITC,ITC4,3,Lombardia
2021-03-07,PIE,11969,4656,7313,11091,878,ITC,ITC1,1,Piemonte
2021-03-30,ABR,5057,2198,2859,3233,1824,ITF,ITF1,13,Abruzzo
2021-01-11,CAM,4072,1871,2201,4072,0,ITF,ITF3,15,Campania
2021-03-04,PAB,1710,1001,709,1481,229,ITH,ITH1,4,Provincia Autonoma Bolzano / Bozen
2021-05-02,CAM,43467,21527,21940,32134,11333,ITF,ITF3,15,Campania
2021-02-05,FVG,2614,785,1829,90,2524,ITH,ITH4,6,Friuli-Venezia Giulia
2021-02-08,EMR,5227,1532,3695,2313,2914,ITH,ITH5,8,Emilia-Romagna
2021-04-24,TOS,13413,6153,7260,5978,7435,ITI,ITI1,9,Toscana
2021-01-14,PIE,9766,3152,6614,9766,0,ITC,ITC1,1,Piemonte
2021-03-04,VEN,12908,4821,8087,9442,3466,ITH,ITH3,5,Veneto
2021-03-10,LAZ,21997,9473,12524,16352,5645,ITI,ITI4,12,Lazio
2021-05-15,UMB,4947,1863,3084,1798,3149,ITI,ITI2,10,Umbria
2021-03-01,MAR,3724,1487,2237,3476,248,ITI,ITI3,11,Marche
2021-04-14,BAS,2041,997,1044,1367,674,ITF,ITF5,17,Basilicata
2021-01-23,PIE,4257,1325,2932,879,3378,ITC,ITC1,1,Piemonte
2021-02-15,CAL,1136,538,598,988,148,ITF,ITF6,18,Calabria
2021-04-24,LAZ,33267,14965,18302,20522,12745,ITI,ITI4,12,Lazio
2021-01-20,PUG,1546,541,1005,1538,8,ITF,ITF4,16,Puglia
2021-02-04,MAR,2341,809,1532,112,2229,ITI,ITI3,11,Marche
2021-02-08,SIC,4086,1759,2327,2128,1958,ITG,ITG1,19,Sicilia
2021-03-02,BAS,792,382,410,657,135,ITF,ITF5,17,Basilicata
2021-04-15,MOL,1899,779,1120,1061,838,ITF,ITF2,14,Molise
2021-03-11,PAT,2293,851,1442,1471,822,ITH,ITH2,4,Provincia Autonoma Trento
2021-03-25,SAR,8791,3702,5089,7487,1304,ITG,ITG2,20,Sardegna
2021-04-05,PUG,12682,6163,6519,12148,534,ITF,ITF4,16,Puglia
2021-01-14,BAS,969,413,556,969,0,ITF,ITF5,17,Basilicata
2021-01-18,BAS,463,157,306,364,99,ITF,ITF5,17,Basilicata
2021-02-22,PAB,526,143,383,514,12,ITH,ITH1,4,Provincia Autonoma Bolzano / Bozen
2021-04-19,VEN,21535,8920,12615,5118,16417,ITH,ITH3,5,Veneto
2021-05-06,VEN,46316,21725,24591,37926,8390,ITH,ITH3,5,Veneto
2021-05-13,PAB,2980,1347,1633,1050,1930,ITH,ITH1,4,Provincia Autonoma Bolzano / Bozen
2021-05-17,TOS,29327,14547,14780,20699,8628,ITI,ITI1,9,Toscana
2021-01-07,SIC,9177,4241,4936,9177,0,ITG,ITG1,19,Sicilia
2021-01-24,LOM,1201,459,742,537,664,ITC,ITC4,3,Lombardia
2021-01-02,PUG,2948,1300,1648,2948,0,ITF,ITF4,16,Puglia
2021-02-10,SAR,1959,765,1194,1441,518,ITG,ITG2,20,Sardegna
2021-03-01,VDA,181,66,115,147,34,ITC,ITC2,2,Valle d'Aosta / Vallée d'Aoste
2021-04-23,CAL,12612,6264,6348,9370,3242,ITF,ITF6,18,Calabria
2021-03-25,PIE,17058,7201,9857,8422,8636,ITC,ITC1,1,Piemonte
2021-03-30,FVG,7092,3143,3949,6170,922,ITH,ITH4,6,Friuli-Venezia Giulia
2021-04-02,PAB,2077,837,1240,720,1357,ITH,ITH1,4,Provincia Autonoma Bolzano / Bozen
2021-01-11,PUG,3751,1588,2163,3751,0,ITF,ITF4,16,Puglia
2021-02-21,PUG,2176,472,1704,2115,61,ITF,ITF4,16,Puglia
2021-03-04,LOM,29387,12138,17249,20258,9129,ITC,ITC4,3,Lombardia
2021-03-07,BAS,882,308,574,844,38,ITF,ITF5,17,Basilicata
2021-01-29,MOL,421,136,285,6,415,ITF,ITF2,14,Molise
2021-03-27,SAR,5712,2174,3538,5290,422,ITG,ITG2,20,Sardegna
2021-04-22,VDA,1067,449,618,684,383,ITC,ITC2,2,Valle d'Aosta / Vallée d'Aoste
2021-02-18,LAZ,10023,4978,5045,9215,808,ITI,ITI4,12,Lazio
2021-01-16,TOS,3271,1046,2225,3271,0,ITI,ITI1,9,Toscana
2021-02-03,CAL,2764,1428,1336,581,2183,ITF,ITF6,18,Calabria
2021-02-11,BAS,951,401,550,868,83,ITF,ITF5,17,Basilicata
2021-05-07,SIC,36627,17296,19331,24999,11628,ITG,ITG1,19,Sicilia
2021-01-01,VEN,1528,471,1057,1528,0,ITH,ITH3,5,Veneto
2021-04-11,LIG,4249,1931,2318,4000,249,ITC,ITC3,7,Liguria
2021-04-27,VDA,977,423,554,685,292,ITC,ITC2,2,Valle d'Aosta / Vallée d'Aoste
2021-01-16,PUG,2507,1033,1474,2507,0,ITF,ITF4,16,Puglia
2021-02-22,EMR,7481,3091,4390,7206,275,ITH,ITH5,8,Emilia-Romagna
2021-02-28,TOS,1649,667,982,922,727,ITI,ITI1,9,Toscana
2021-03-25,ABR,5685,2560,3125,3070,2615,ITF,ITF1,13,Abruzzo
2021-05-16,MOL,1209,563,646,1027,182,ITF,ITF2,14,Molise
2021-04-25,MAR,8598,3993,4605,7024,1574,ITI,ITI3,11,Marche
2021-01-27,UMB,840,330,510,13,827,ITI,ITI2,10,Umbria
2021-03-27,ABR,6121,2620,3501,3636,2485,ITF,ITF1,13,Abruzzo
2021-02-02,PUG,4342,1845,2497,593,3749,ITF,ITF4,16,Puglia
2021-01-08,VDA,299,130,169,299,0,ITC,ITC2,2,Valle d'Aosta / Vallée d'Aoste
2021-02-13,LIG,1080,508,572,800,280,ITC,ITC3,7,Liguria
2021-03-08,SIC,13539,5825,7714,10731,2808,ITG,ITG1,19,Sicilia
2021-03-18,MOL,1156,476,680,692,464,ITF,ITF2,14,Molise
2021-04-29,EMR,44694,21001,23693,27159,17535,ITH,ITH5,8,Emilia-Romagna
2021-02-09,MAR,124,42,82,46,78,ITI,ITI3,11,Marche
2021-04-30,MAR,13938,6100,7838,5398,8540,ITI,ITI3,11,Marche
2021-05-01,ABR,10737,5049,5688,5759,4978,ITF,ITF1,13,Abruzzo
2021-01-30,FVG,2273,744,1529,270,2003,ITH,ITH4,6,Friuli-Venezia Giulia
2021-04-25,VDA,848,408,440,709,139,ITC,ITC2,2,Valle d'Aosta / Vallée d'Aoste
2021-05-14,PAT,5236,2507,2729,3889,1347,ITH,ITH2,4,Provincia Autonoma Trento
2021-01-05,VDA,150,54,96,150,0,ITC,ITC2,2,Valle d'Aosta / Vallée d'Aoste
2021-02-11,PIE,6764,2107,4657,3006,3758,ITC,ITC1,1,Piemonte
2021-02-13,PAB,318,79,239,312,6,ITH,ITH1,4,Provincia Autonoma Bolzano / Bozen
2021-04-01,PAT,2892,1227,1665,1799,1093,ITH,ITH2,4,Provincia Autonoma Trento
2021-04-19,EMR,20813,9749,11064,14559,6254,ITH,ITH5,8,Emilia-Romagna
2021-04-22,SIC,27096,12807,14289,20555,6541,ITG,ITG1,19,Sicilia
2021-02-19,LAZ,10050,5082,4968,9220,830,ITI,ITI4,12,Lazio
2021-03-29,SIC,15001,7035,7966,10484,4517,ITG,ITG1,19,Sicilia
2021-05-08,EMR,31048,14527,16521,19692,11356,ITH,ITH5,8,Emilia-Romagna
2021-02-03,FVG,2647,791,1856,23,2624,ITH,ITH4,6,Friuli-Venezia Giulia
2021-04-06,MAR,8878,3693,5185,8065,813,ITI,ITI3,11,Marche
2021-01-13,CAL,2028,1022,1006,2028,0,ITF,ITF6,18,Calabria
2021-03-13,SAR,2751,1072,1679,2470,281,ITG,ITG2,20,Sardegna
2021-04-13,FVG,7363,3289,4074,5758,1605,ITH,ITH4,6,Friuli-Venezia Giulia
2021-01-12,BAS,217,88,129,217,0,ITF,ITF5,17,Basilicata
2021-02-07,CAL,858,427,431,146,712,ITF,ITF6,18,Calabria
2021-02-24,LIG,3763,1560,2203,3505,258,ITC,ITC3,7,Liguria
2021-02-24,PAB,1367,406,961,1355,12,ITH,ITH1,4,Provincia Autonoma Bolzano / Bozen
2021-03-13,CAL,6660,2941,3719,5670,990,ITF,ITF6,18,Calabria
2021-05-12,VEN,35730,17267,18463,30840,4890,ITH,ITH3,5,Veneto
2021-01-13,ABR,1253,440,813,1253,0,ITF,ITF1,13,Abruzzo
2021-02-08,VEN,4974,1540,3434,1928,3046,ITH,ITH3,5,Veneto
2021-02-16,SIC,4370,2282,2088,3905,465,ITG,ITG1,19,Sicilia
2021-04-06,TOS,22166,9770,12396,18453,3713,ITI,ITI1,9,Toscana
2021-04-07,BAS,1218,549,669,1181,37,ITF,ITF5,17,Basilicata
2021-01-10,VDA,220,71,149,220,0,ITC,ITC2,2,Valle d'Aosta / Vallée d'Aoste
2021-02-27,MAR,3356,1435,1921,3147,209,ITI,ITI3,11,Marche
2021-03-29,MOL,2033,835,1198,1547,486,ITF,ITF2,14,Molise
2021-04-02,UMB,4263,1708,2555,3516,747,ITI,ITI2,10,Umbria
2021-01-12,MOL,336,114,222,336,0,ITF,ITF2,14,Molise
2021-02-01,EMR,10318,3609,6709,362,9956,ITH,ITH5,8,Emilia-Romagna
2021-02-23,LIG,3806,1559,2247,3697,109,ITC,ITC3,7,Liguria
2021-04-23,FVG,7451,3371,4080,3595,3856,ITH,ITH4,6,Friuli-Venezia Giulia
2021-02-02,PAT,907,240,667,190,717,ITH,ITH2,4,Provincia Autonoma Trento
2021-05-12,EMR,37901,17838,20063,28361,9540,ITH,ITH5,8,Emilia-Romagna
2021-01-10,FVG,2939,918,2021,2939,0,ITH,ITH4,6,Friuli-Venezia Giulia
2021-03-03,VDA,255,118,137,186,69,ITC,ITC2,2,Valle d'Aosta / Vallée d'Aoste
2021-01-06,MAR,2181,792,1389,2181,0,ITI,ITI3,11,Marche
2021-01-13,FVG,2650,834,1816,2650,0,ITH,ITH4,6,Friuli-Venezia Giulia
2021-01-19,CAL,1108,488,620,1098,10,ITF,ITF6,18,Calabria
2021-02-04,TOS,4253,1594,2659,961,3292,ITI,ITI1,9,Toscana
2021-03-05,MOL,1219,649,570,1015,204,ITF,ITF2,14,Molise
2021-03-24,LOM,43305,15624,27681,31439,11866,ITC,ITC4,3,Lombardia
2021-05-03,FVG,7142,3252,3890,3376,3766,ITH,ITH4,6,Friuli-Venezia Giulia
2020-12-31,VDA,18,4,14,18,0,ITC,ITC2,2,Valle d'Aosta / Vallée d'Aoste
2021-01-23,CAL,400,186,214,358,42,ITF,ITF6,18,Calabria
2021-05-15,SAR,13365,6234,7131,9940,3425,ITG,ITG2,20,Sardegna
2021-01-10,CAL,929,524,405,929,0,ITF,ITF6,18,Calabria
2021-03-07,ABR,2515,628,1887,2515,0,ITF,ITF1,13,Abruzzo
2021-03-24,ABR,6387,2785,3602,4134,2253,ITF,ITF1,13,Abruzzo
2021-04-01,PUG,13479,6148,7331,7137,6342,ITF,ITF4,16,Puglia
2021-01-15,PUG,4552,1866,2686,4552,0,ITF,ITF4,16,Puglia
2021-01-23,BAS,715,302,413,33,682,ITF,ITF5,17,Basilicata
2021-02-17,LIG,2688,1181,1507,2263,425,ITC,ITC3,7,Liguria
2021-03-14,MAR,2499,1031,1468,1906,593,ITI,ITI3,11,Marche
2021-01-31,TOS,3050,1129,1921,106,2944,ITI,ITI1,9,Toscana
2021-03-20,PAB,1757,848,909,1132,625,ITH,ITH1,4,Provincia Autonoma Bolzano / Bozen
2021-04-10,LOM,52188,21623,30565,40395,11793,ITC,ITC4,3,Lombardia
2021-05-10,LIG,12485,5498,6987,6120,6365,ITC,ITC3,7,Liguria
2021-05-14,PUG,43721,19977,23744,28148,15573,ITF,ITF4,16,Puglia
2021-03-14,VDA,392,200,192,392,0,ITC,ITC2,2,Valle d'Aosta / Vallée d'Aoste
2021-03-27,UMB,4252,1512,2740,3912,340,ITI,ITI2,10,Umbria
2021-03-26,TOS,20390,9152,11238,14640,5750,ITI,ITI1,9,Toscana
2021-05-18,EMR,17336,7991,9345,10583,6753,ITH,ITH5,8,Emilia-Romagna
2021-03-06,LIG,3303,1841,1462,2598,705,ITC,ITC3,7,Liguria
2021-04-17,LAZ,32298,14174,18124,20353,11945,ITI,ITI4,12,Lazio
2021-04-26,PAB,1541,771,770,1536,5,ITH,ITH1,4,Provincia Autonoma Bolzano / Bozen
2021-05-08,VEN,41047,18588,22459,29274,11773,ITH,ITH3,5,Veneto
2021-01-06,VDA,65,33,32,65,0,ITC,ITC2,2,Valle d'Aosta / Vallée d'Aoste
2021-01-25,LIG,2725,889,1836,478,2247,ITC,ITC3,7,Liguria
2021-02-23,MAR,3267,1397,1870,3211,56,ITI,ITI3,11,Marche
2021-03-22,LOM,40301,14290,26011,29759,10542,ITC,ITC4,3,Lombardia
2021-04-29,VEN,50143,23328,26815,36950,13193,ITH,ITH3,5,Veneto
2021-01-09,SIC,7326,3424,3902,7326,0,ITG,ITG1,19,Sicilia
2021-03-25,CAL,6950,3282,3668,4435,2515,ITF,ITF6,18,Calabria
2021-04-12,LIG,12384,5475,6909,10365,2019,ITC,ITC3,7,Liguria
2021-05-15,PAB,6993,3681,3312,6698,295,ITH,ITH1,4,Provincia Autonoma Bolzano / Bozen
2021-01-30,LOM,12323,4570,7753,174,12149,ITC,ITC4,3,Lombardia
2021-02-12,PAB,730,217,513,482,248,ITH,ITH1,4,Provincia Autonoma Bolzano / Bozen
2021-03-05,MAR,6179,2860,3319,4712,1467,ITI,ITI3,11,Marche
2021-04-01,TOS,26897,11104,15793,16296,10601,ITI,ITI1,9,Toscana
2021-01-20,PAT,291,73,218,279,12,ITH,ITH2,4,Provincia Autonoma Trento
2021-02-20,SAR,2041,855,1186,1707,334,ITG,ITG2,20,Sardegna
2021-05-05,FVG,9630,4199,5431,6206,3424,ITH,ITH4,6,Friuli-Venezia Giulia
2021-01-22,MAR,487,167,320,194,293,ITI,ITI3,11,Marche
2021-02-22,VEN,7013,3041,3972,6626,387,ITH,ITH3,5,Veneto
2021-01-27,PAB,84,28,56,1,83,ITH,ITH1,4,Provincia Autonoma Bolzano / Bozen
2021-02-12,LIG,1924,689,1235,899,1025,ITC,ITC3,7,Liguria
2021-03-03,MAR,6650,3049,3601,5770,880,ITI,ITI3,11,Marche
2021-03-09,PAB,1194,543,651,1192,2,ITH,ITH1,4,Provincia Autonoma Bolzano / Bozen
2021-03-23,LOM,42479,15387,27092,29638,12841,ITC,ITC4,3,Lombardia
2021-03-31,MAR,7374,3087,4287,4350,3024,ITI,ITI3,11,Marche
2021-01-02,PAT,502,143,359,502,0,ITH,ITH2,4,Provincia Autonoma Trento
2021-02-05,LOM,25591,7431,18160,2383,23208,ITC,ITC4,3,Lombardia
2021-02-15,SAR,958,349,609,927,31,ITG,ITG2,20,Sardegna
2021-02-26,LIG,3765,1524,2241,3437,328,ITC,ITC3,7,Liguria
2021-04-14,ABR,6501,2895,3606,4423,2078,ITF,ITF1,13,Abruzzo
2021-03-11,PUG,14364,6188,8176,11256,3108,ITF,ITF4,16,Puglia
2021-03-13,PIE,13034,4717,8317,11591,1443,ITC,ITC1,1,Piemonte
2021-05-09,LOM,69386,32772,36614,56415,12971,ITC,ITC4,3,Lombardia
2021-02-21,TOS,5105,2089,3016,4935,170,ITI,ITI1,9,Toscana
2021-03-04,UMB,4485,1853,2632,3657,828,ITI,ITI2,10,Umbria
2021-04-09,BAS,1151,350,801,1088,63,ITF,ITF5,17,Basilicata
2021-04-16,CAM,34301,16552,17749,23643,10658,ITF,ITF3,15,Campania
2021-02-21,PAT,155,92,63,43,112,ITH,ITH2,4,Provincia Autonoma Trento
2021-03-31,SIC,14606,6750,7856,9578,5028,ITG,ITG1,19,Sicilia
2021-05-08,PAB,4416,2379,2037,3758,658,ITH,ITH1,4,Provincia Autonoma Bolzano / Bozen
2021-02-10,CAL,2460,1075,1385,837,1623,ITF,ITF6,18,Calabria
2021-02-13,UMB,115,28,87,112,3,ITI,ITI2,10,Umbria
2021-03-02,PIE,11193,4503,6690,10377,816,ITC,ITC1,1,Piemonte
2021-05-18,MOL,1603,855,748,953,650,ITF,ITF2,14,Molise
2021-01-11,PAT,730,221,509,730,0,ITH,ITH2,4,Provincia Autonoma Trento
2021-04-12,PAB,2105,946,1159,2098,7,ITH,ITH1,4,Provincia Autonoma Bolzano / Bozen
2021-04-23,VDA,921,443,478,538,383,ITC,ITC2,2,Valle d'Aosta / Vallée d'Aoste
2021-04-26,LOM,87899,40911,46988,68753,19146,ITC,ITC4,3,Lombardia
2021-03-20,LIG,2316,995,1321,1142,1174,ITC,ITC3,7,Liguria
2021-04-08,EMR,30670,14058,16612,25396,5274,ITH,ITH5,8,Emilia-Romagna
2021-04-30,LIG,14317,6382,7935,5748,8569,ITC,ITC3,7,Liguria
2021-05-06,EMR,35342,16340,19002,22364,12978,ITH,ITH5,8,Emilia-Romagna
2021-03-23,SAR,6153,2638,3515,5075,1078,ITG,ITG2,20,Sardegna
2021-01-05,VEN,7330,2182,5148,7330,0,ITH,ITH3,5,Veneto
2021-01-30,SIC,7841,3571,4270,175,7666,ITG,ITG1,19,Sicilia
2021-02-07,MOL,66,32,34,19,47,ITF,ITF2,14,Molise
2021-02-14,LAZ,5773,2370,3403,5303,470,ITI,ITI4,12,Lazio
2021-03-03,FVG,3636,1625,2011,2363,1273,ITH,ITH4,6,Friuli-Venezia Giulia
2021-03-13,ABR,4125,1421,2704,3083,1042,ITF,ITF1,13,Abruzzo
2020-12-27,PUG,509,252,257,509,0,ITF,ITF4,16,Puglia
2021-05-12,ABR,9596,4576,5020,6025,3571,ITF,ITF1,13,Abruzzo
2021-03-30,LIG,12147,5379,6768,8758,3389,ITC,ITC3,7,Liguria
2021-01-14,SIC,5253,2516,2737,5253,0,ITG,ITG1,19,Sicilia
2021-03-12,ABR,6016,1985,4031,4434,1582,ITF,ITF1,13,Abruzzo
2021-02-16,MOL,156,70,86,150,6,ITF,ITF2,14,Molise
2021-03-20,MOL,2320,968,1352,999,1321,ITF,ITF2,14,Molise
2021-04-08,PAB,2754,1336,1418,2551,203,ITH,ITH1,4,Provincia Autonoma Bolzano / Bozen
2021-03-16,MAR,3471,1485,1986,290,3181,ITI,ITI3,11,Marche
2021-03-21,SIC,15228,7338,7890,11253,3975,ITG,ITG1,19,Sicilia
2020-12-27,SAR,65,34,31,65,0,ITG,ITG2,20,Sardegna
2021-03-02,CAM,12754,4554,8200,8409,4345,ITF,ITF3,15,Campania
2021-04-01,EMR,23860,10725,13135,19329,4531,ITH,ITH5,8,Emilia-Romagna
2021-01-06,CAL,928,501,427,928,0,ITF,ITF6,18,Calabria
2021-01-17,PIE,3518,1168,2350,2870,648,ITC,ITC1,1,Piemonte
2021-04-22,LIG,13811,6192,7619,8747,5064,ITC,ITC3,7,Liguria
2021-04-27,VEN,28076,12737,15339,21149,6927,ITH,ITH3,5,Veneto
2021-01-26,PIE,6330,1879,4451,735,5595,ITC,ITC1,1,Piemonte
2021-02-17,MOL,72,32,40,57,15,ITF,ITF2,14,Molise
2021-03-22,CAM,12739,5920,6819,10699,2040,ITF,ITF3,15,Campania
2021-03-31,CAM,22679,10905,11774,19240,3439,ITF,ITF3,15,Campania
2021-04-01,LOM,42766,17155,25611,26719,16047,ITC,ITC4,3,Lombardia
2021-04-18,PUG,22501,10758,11743,21437,1064,ITF,ITF4,16,Puglia
2021-04-20,VDA,932,430,502,738,194,ITC,ITC2,2,Valle d'Aosta / Vallée d'Aoste
2020-12-27,FVG,262,149,113,262,0,ITH,ITH4,6,Friuli-Venezia Giulia
2021-01-20,VEN,1038,368,670,386,652,ITH,ITH3,5,Veneto
2021-02-12,UMB,671,224,447,665,6,ITI,ITI2,10,Umbria
2021-03-06,FVG,3487,1193,2294,3162,325,ITH,ITH4,6,Friuli-Venezia Giulia
2021-03-10,LIG,5878,2840,3038,3972,1906,ITC,ITC3,7,Liguria
2021-01-10,TOS,3001,1104,1897,3001,0,ITI,ITI1,9,Toscana
2021-03-06,LOM,21315,9086,12229,16801,4514,ITC,ITC4,3,Lombardia
2021-04-02,ABR,6684,3093,3591,5197,1487,ITF,ITF1,13,Abruzzo
2021-01-18,LOM,9156,2968,6188,8175,981,ITC,ITC4,3,Lombardia
2021-03-12,VDA,531,175,356,305,226,ITC,ITC2,2,Valle d'Aosta / Vallée d'Aoste
2021-04-26,PIE,19687,8706,10981,15308,4379,ITC,ITC1,1,Piemonte
2021-01-05,LOM,7821,2566,5255,7821,0,ITC,ITC4,3,Lombardia
2021-04-04,ABR,1631,767,864,1502,129,ITF,ITF1,13,Abruzzo
2021-05-09,SAR,6125,2873,3252,5195,930,ITG,ITG2,20,Sardegna
2021-02-02,FVG,2467,806,1661,217,2250,ITH,ITH4,6,Friuli-Venezia Giulia
2021-03-26,ABR,5301,2260,3041,3231,2070,ITF,ITF1,13,Abruzzo
2020-12-27,PAT,103,40,63,103,0,ITH,ITH2,4,Provincia Autonoma Trento
2021-01-19,EMR,2045,505,1540,2028,17,ITH,ITH5,8,Emilia-Romagna
2021-03-08,LIG,5622,2456,3166,3933,1689,ITC,ITC3,7,Liguria
2021-01-18,EMR,3127,879,2248,2449,678,ITH,ITH5,8,Emilia-Romagna
2021-01-23,CAM,3838,2028,1810,273,3565,ITF,ITF3,15,Campania
2021-01-16,ABR,928,428,500,928,0,ITF,ITF1,13,Abruzzo
2021-01-27,VEN,7137,2062,5075,241,6896,ITH,ITH3,5,Veneto
2021-03-17,CAM,11587,5098,6489,5007,6580,ITF,ITF3,15,Campania
2021-04-28,ABR,9498,4580,4918,7479,2019,ITF,ITF1,13,Abruzzo
2021-04-28,VDA,1217,632,585,713,504,ITC,ITC2,2,Valle d'Aosta / Vallée d'Aoste
2021-01-24,SIC,4308,2252,2056,143,4165,ITG,ITG1,19,Sicilia
2021-01-26,UMB,816,390,426,18,798,ITI,ITI2,10,Umbria
2021-03-27,LIG,3921,1538,2383,2525,1396,ITC,ITC3,7,Liguria
2021-04-03,SAR,4531,1745,2786,2694,1837,ITG,ITG2,20,Sardegna
2021-04-27,CAL,9855,4854,5001,7996,1859,ITF,ITF6,18,Calabria
2021-05-06,LAZ,48495,22566,25929,31082,17413,ITI,ITI4,12,Lazio
2021-03-01,CAL,2682,1527,1155,2232,450,ITF,ITF6,18,Calabria
2021-04-02,VDA,873,344,529,648,225,ITC,ITC2,2,Valle d'Aosta / Vallée d'Aoste
2021-04-14,MAR,10217,4565,5652,9845,372,ITI,ITI3,11,Marche
2021-05-07,LIG,13561,6022,7539,5796,7765,ITC,ITC3,7,Liguria
2021-04-17,FVG,7446,3231,4215,5964,1482,ITH,ITH4,6,Friuli-Venezia Giulia
2021-04-18,PAT,1853,844,1009,1845,8,ITH,ITH2,4,Provincia Autonoma Trento
2021-04-29,LAZ,38479,17163,21316,25280,13199,ITI,ITI4,12,Lazio
2021-02-02,SAR,1482,655,827,241,1241,ITG,ITG2,20,Sardegna
2021-02-22,LOM,11893,4808,7085,11585,308,ITC,ITC4,3,Lombardia
2021-01-20,SAR,210,77,133,208,2,ITG,ITG2,20,Sardegna
2021-01-22,UMB,276,105,171,32,244,ITI,ITI2,10,Umbria
2021-02-22,MAR,3413,1499,1914,3338,75,ITI,ITI3,11,Marche
2021-03-27,CAM,21270,10029,11241,17407,3863,ITF,ITF3,15,Campania
2021-01-12,VDA,302,72,230,302,0,ITC,ITC2,2,Valle d'Aosta / Vallée d'Aoste
2021-01-15,PAT,594,131,463,594,0,ITH,ITH2,4,Provincia Autonoma Trento
2021-03-27,LOM,32309,12316,19993,23705,8604,ITC,ITC4,3,Lombardia
2021-04-04,MAR,3824,1792,2032,2655,1169,ITI,ITI3,11,Marche
2021-04-08,PIE,25118,10919,14199,20388,4730,ITC,ITC1,1,Piemonte
2021-04-22,FVG,6752,3071,3681,3076,3676,ITH,ITH4,6,Friuli-Venezia Giulia
2021-05-18,VEN,26086,12219,13867,13045,13041,ITH,ITH3,5,Veneto
2021-01-31,UMB,1058,276,782,25,1033,ITI,ITI2,10,Umbria
2021-04-10,MAR,10918,4618,6300,10604,314,ITI,ITI3,11,Marche
2021-04-17,LIG,7382,3217,4165,6632,750,ITC,ITC3,7,Liguria
2021-05-07,FVG,10256,4644,5612,6839,3417,ITH,ITH4,6,Friuli-Venezia Giulia
2021-01-05,SAR,1327,446,881,1327,0,ITG,ITG2,20,Sardegna
2021-03-31,LIG,11844,5207,6637,9074,2770,ITC,ITC3,7,Liguria
2021-01-03,UMB,270,112,158,270,0,ITI,ITI2,10,Umbria
2021-02-11,MAR,1987,657,1330,1598,389,ITI,ITI3,11,Marche
2021-03-02,PAB,695,200,495,693,2,ITH,ITH1,4,Provincia Autonoma Bolzano / Bozen
2021-05-03,BAS,4516,2045,2471,3688,828,ITF,ITF5,17,Basilicata
2021-01-20,TOS,1331,637,694,1083,248,ITI,ITI1,9,Toscana
2021-02-06,FVG,1154,338,816,22,1132,ITH,ITH4,6,Friuli-Venezia Giulia
2021-01-13,SIC,5266,2491,2775,5266,0,ITG,ITG1,19,Sicilia
2021-02-24,MOL,666,278,388,333,333,ITF,ITF2,14,Molise
2021-03-04,BAS,1874,889,985,1081,793,ITF,ITF5,17,Basilicata
2021-02-10,PIE,7534,2371,5163,1316,6218,ITC,ITC1,1,Piemonte
2021-03-04,SIC,15193,6550,8643,10995,4198,ITG,ITG1,19,Sicilia
2021-03-05,SIC,15879,6839,9040,11559,4320,ITG,ITG1,19,Sicilia
2021-04-03,LOM,36180,14843,21337,26121,10059,ITC,ITC4,3,Lombardia
2021-01-16,LOM,15415,5723,9692,15415,0,ITC,ITC4,3,Lombardia
2021-02-23,SIC,8910,4670,4240,8447,463,ITG,ITG1,19,Sicilia
2021-03-08,UMB,3668,1799,1869,2305,1363,ITI,ITI2,10,Umbria
2021-02-14,BAS,151,48,103,151,0,ITF,ITF5,17,Basilicata
2021-04-02,MAR,6875,2973,3902,6135,740,ITI,ITI3,11,Marche
2021-04-08,LIG,13727,6157,7570,11683,2044,ITC,ITC3,7,Liguria
2021-04-17,UMB,6664,3058,3606,5324,1340,ITI,ITI2,10,Umbria
2021-05-01,FVG,7163,3232,3931,6119,1044,ITH,ITH4,6,Friuli-Venezia Giulia
2021-05-12,BAS,4712,2320,2392,2836,1876,ITF,ITF5,17,Basilicata
2021-02-17,CAL,1680,672,1008,1469,211,ITF,ITF6,18,Calabria
2021-02-17,PUG,4270,1745,2525,3669,601,ITF,ITF4,16,Puglia
2021-04-18,SAR,5155,2239,2916,2287,2868,ITG,ITG2,20,Sardegna
2021-04-18,VEN,17519,7255,10264,9946,7573,ITH,ITH3,5,Veneto
2020-12-27,VEN,880,395,485,880,0,ITH,ITH3,5,Veneto
2021-01-02,LAZ,6707,2631,4076,6707,0,ITI,ITI4,12,Lazio
2021-05-09,PAT,2322,1210,1112,1978,344,ITH,ITH2,4,Provincia Autonoma Trento
2021-01-22,FVG,90,30,60,0,90,ITH,ITH4,6,Friuli-Venezia Giulia
2021-02-22,ABR,2643,1174,1469,2613,30,ITF,ITF1,13,Abruzzo
2021-05-09,PUG,30304,12403,17901,14836,15468,ITF,ITF4,16,Puglia
2021-01-10,PAB,2,2,0,2,0,ITH,ITH1,4,Provincia Autonoma Bolzano / Bozen
2021-03-24,PAT,2375,940,1435,1555,820,ITH,ITH2,4,Provincia Autonoma Trento
2021-04-10,ABR,8772,4057,4715,6264,2508,ITF,ITF1,13,Abruzzo
2021-05-07,UMB,10076,4681,5395,6877,3199,ITI,ITI2,10,Umbria
2021-01-04,EMR,7272,2514,4758,7272,0,ITH,ITH5,8,Emilia-Romagna
2021-03-02,LIG,4074,1689,2385,3764,310,ITC,ITC3,7,Liguria
2021-03-09,LAZ,20872,8939,11933,15675,5197,ITI,ITI4,12,Lazio
2021-04-16,FVG,6909,2995,3914,4986,1923,ITH,ITH4,6,Friuli-Venezia Giulia
2021-05-06,SIC,28973,13712,15261,18409,10564,ITG,ITG1,19,Sicilia
2021-04-13,UMB,7672,3396,4276,6003,1669,ITI,ITI2,10,Umbria
2021-05-04,PAT,4473,2421,2052,4383,90,ITH,ITH2,4,Provincia Autonoma Trento
2021-02-02,VEN,6411,1847,4564,392,6019,ITH,ITH3,5,Veneto
2021-03-31,PAB,1831,693,1138,820,1011,ITH,ITH1,4,Provincia Autonoma Bolzano / Bozen
2021-04-21,PAT,2892,1348,1544,2842,50,ITH,ITH2,4,Provincia Autonoma Trento
2021-03-12,EMR,18084,7528,10556,11367,6717,ITH,ITH5,8,Emilia-Romagna
2021-04-24,PIE,27408,12404,15004,21777,5631,ITC,ITC1,1,Piemonte
2021-05-17,CAM,49208,21603,27605,24077,25131,ITF,ITF3,15,Campania
2021-03-14,PIE,8200,3332,4868,5308,2892,ITC,ITC1,1,Piemonte
2021-03-23,PUG,10401,4993,5408,3936,6465,ITF,ITF4,16,Puglia
2021-01-12,MAR,1226,413,813,1226,0,ITI,ITI3,11,Marche
2021-01-27,SAR,1409,494,915,79,1330,ITG,ITG2,20,Sardegna
2021-02-19,BAS,1622,737,885,1560,62,ITF,ITF5,17,Basilicata
2021-04-03,CAL,8819,3787,5032,4201,4618,ITF,ITF6,18,Calabria
2021-04-28,BAS,4701,2157,2544,4260,441,ITF,ITF5,17,Basilicata
2021-02-11,ABR,816,262,554,773,43,ITF,ITF1,13,Abruzzo
2021-01-08,BAS,554,219,335,554,0,ITF,ITF5,17,Basilicata
2021-02-20,BAS,1161,531,630,1043,118,ITF,ITF5,17,Basilicata
2021-03-26,BAS,1956,703,1253,1695,261,ITF,ITF5,17,Basilicata
2021-04-29,SIC,31668,14759,16909,22330,9338,ITG,ITG1,19,Sicilia
2021-05-07,PAB,4180,2055,2125,3662,518,ITH,ITH1,4,Provincia Autonoma Bolzano / Bozen
2021-01-09,MOL,450,152,298,450,0,ITF,ITF2,14,Molise
2021-01-14,LAZ,5454,2134,3320,5454,0,ITI,ITI4,12,Lazio
2021-03-01,LIG,3500,1427,2073,3378,122,ITC,ITC3,7,Liguria
2021-03-16,VDA,180,37,143,118,62,ITC,ITC2,2,Valle d'Aosta / Vallée d'Aoste
2021-04-18,FVG,6037,2798,3239,5630,407,ITH,ITH4,6,Friuli-Venezia Giulia
2021-02-17,PAT,1110,425,685,1020,90,ITH,ITH2,4,Provincia Autonoma Trento
2021-03-16,ABR,3484,1452,2032,1830,1654,ITF,ITF1,13,Abruzzo
2021-05-14,MOL,2641,1213,1428,1924,717,ITF,ITF2,14,Molise
2021-02-03,EMR,9340,2992,6348,973,8367,ITH,ITH5,8,Emilia-Romagna
2021-03-08,PAB,1200,526,674,1173,27,ITH,ITH1,4,Provincia Autonoma Bolzano / Bozen
2021-03-23,FVG,3753,1558,2195,1613,2140,ITH,ITH4,6,Friuli-Venezia Giulia
2021-03-24,FVG,3766,1530,2236,2286,1480,ITH,ITH4,6,Friuli-Venezia Giulia
2021-04-03,VEN,21879,9598,12281,14162,7717,ITH,ITH3,5,Veneto
2021-04-19,SIC,18516,8761,9755,12809,5707,ITG,ITG1,19,Sicilia
2021-03-01,CAM,12127,4247,7880,8015,4112,ITF,ITF3,15,Campania
2021-02-04,CAM,7943,3429,4514,1308,6635,ITF,ITF3,15,Campania
2021-03-30,UMB,3948,1705,2243,2416,1532,ITI,ITI2,10,Umbria
2021-03-17,PIE,12515,5053,7462,5224,7291,ITC,ITC1,1,Piemonte
2021-04-04,VDA,571,252,319,570,1,ITC,ITC2,2,Valle d'Aosta / Vallée d'Aoste
2021-02-04,PIE,10202,3338,6864,588,9614,ITC,ITC1,1,Piemonte
2021-03-07,MAR,5182,2108,3074,4429,753,ITI,ITI3,11,Marche
2021-01-31,PIE,4112,1752,2360,112,4000,ITC,ITC1,1,Piemonte
2021-04-21,PUG,22960,10596,12364,19229,3731,ITF,ITF4,16,Puglia
2021-04-30,LOM,116806,54601,62205,89647,27159,ITC,ITC4,3,Lombardia
2021-01-03,EMR,2754,941,1813,2754,0,ITH,ITH5,8,Emilia-Romagna
2021-01-20,UMB,613,222,391,613,0,ITI,ITI2,10,Umbria
2021-03-01,LOM,18796,8231,10565,17091,1705,ITC,ITC4,3,Lombardia
2021-03-04,LAZ,18663,8017,10646,13647,5016,ITI,ITI4,12,Lazio
2021-04-15,LOM,49344,21824,27520,35534,13810,ITC,ITC4,3,Lombardia
2021-05-02,LIG,3872,1768,2104,500,3372,ITC,ITC3,7,Liguria
2021-01-16,EMR,5626,1718,3908,5626,0,ITH,ITH5,8,Emilia-Romagna
2021-02-11,VDA,231,107,124,222,9,ITC,ITC2,2,Valle d'Aosta / Vallée d'Aoste
2021-03-23,PAT,2443,943,1500,1703,740,ITH,ITH2,4,Provincia Autonoma Trento
2021-03-24,PUG,12971,5979,6992,5716,7255,ITF,ITF4,16,Puglia
2021-05-08,PIE,33756,16023,17733,18156,15600,ITC,ITC1,1,Piemonte
2021-05-08,UMB,8093,3726,4367,4899,3194,ITI,ITI2,10,Umbria
2021-01-06,LOM,7061,2492,4569,7061,0,ITC,ITC4,3,Lombardia
2021-01-20,PAB,617,252,365,409,208,ITH,ITH1,4,Provincia Autonoma Bolzano / Bozen
2021-01-28,TOS,6281,1882,4399,354,5927,ITI,ITI1,9,Toscana
2021-03-26,VDA,498,204,294,491,7,ITC,ITC2,2,Valle d'Aosta / Vallée d'Aoste
2021-04-05,BAS,723,233,490,421,302,ITF,ITF5,17,Basilicata
2021-05-04,PUG,34551,14561,19990,18225,16326,ITF,ITF4,16,Puglia
2021-02-18,PIE,4789,2093,2696,4359,430,ITC,ITC1,1,Piemonte
2021-05-15,MAR,13954,6376,7578,8068,5886,ITI,ITI3,11,Marche
2021-01-23,UMB,280,100,180,2,278,ITI,ITI2,10,Umbria
2021-02-02,MAR,1192,397,795,73,1119,ITI,ITI3,11,Marche
2021-04-07,PAB,1777,802,975,1238,539,ITH,ITH1,4,Provincia Autonoma Bolzano / Bozen
2021-04-09,EMR,25401,11527,13874,19754,5647,ITH,ITH5,8,Emilia-Romagna
2021-05-19,CAM,33618,14339,19279,22923,10695,ITF,ITF3,15,Campania
2021-01-11,TOS,5094,1691,3403,5094,0,ITI,ITI1,9,Toscana
2021-03-22,LIG,7660,3398,4262,4728,2932,ITC,ITC3,7,Liguria
2021-04-03,MAR,7573,3204,4369,6903,670,ITI,ITI3,11,Marche
2021-02-25,SIC,10121,5251,4870,8955,1166,ITG,ITG1,19,Sicilia
2021-03-20,CAM,13880,6428,7452,10141,3739,ITF,ITF3,15,Campania
2021-05-05,UMB,7153,3274,3879,3858,3295,ITI,ITI2,10,Umbria
2021-04-15,ABR,7746,3613,4133,5907,1839,ITF,ITF1,13,Abruzzo
2020-12-30,PIE,730,322,408,730,0,ITC,ITC1,1,Piemonte
2021-02-15,CAM,5470,2516,2954,5297,173,ITF,ITF3,15,Campania
2021-04-25,BAS,2985,1458,1527,2931,54,ITF,ITF5,17,Basilicata
2021-01-04,BAS,607,271,336,607,0,ITF,ITF5,17,Basilicata
2021-04-06,PAB,2249,1117,1132,2146,103,ITH,ITH1,4,Provincia Autonoma Bolzano / Bozen
2021-04-23,LAZ,37550,18010,19540,22320,15230,ITI,ITI4,12,Lazio
2021-01-23,PAB,197,117,80,0,197,ITH,ITH1,4,Provincia Autonoma Bolzano / Bozen
2020-12-27,VDA,20,9,11,20,0,ITC,ITC2,2,Valle d'Aosta / Vallée d'Aoste
2021-01-06,ABR,1830,664,1166,1830,0,ITF,ITF1,13,Abruzzo
2021-01-31,FVG,2715,836,1879,385,2330,ITH,ITH4,6,Friuli-Venezia Giulia
2021-05-05,PAB,4153,1945,2208,2038,2115,ITH,ITH1,4,Provincia Autonoma Bolzano / Bozen
2021-01-04,LAZ,7480,2908,4572,7480,0,ITI,ITI4,12,Lazio
2021-02-08,MAR,833,258,575,371,462,ITI,ITI3,11,Marche
2021-04-08,FVG,7207,3014,4193,5287,1920,ITH,ITH4,6,Friuli-Venezia Giulia
2021-03-08,EMR,12069,4975,7094,9398,2671,ITH,ITH5,8,Emilia-Romagna
2021-05-01,MAR,9320,3924,5396,3576,5744,ITI,ITI3,11,Marche
2021-05-16,EMR,25335,11914,13421,18250,7085,ITH,ITH5,8,Emilia-Romagna
2021-01-28,SAR,2968,1044,1924,69,2899,ITG,ITG2,20,Sardegna
2021-02-07,CAM,2929,1382,1547,2158,771,ITF,ITF3,15,Campania
2021-02-09,CAM,4643,2202,2441,4391,252,ITF,ITF3,15,Campania
2021-02-27,PAB,2457,759,1698,2447,10,ITH,ITH1,4,Provincia Autonoma Bolzano / Bozen
2021-05-18,MAR,11059,5256,5803,7655,3404,ITI,ITI3,11,Marche
2021-03-17,FVG,3229,1265,1964,741,2488,ITH,ITH4,6,Friuli-Venezia Giulia
2021-01-15,EMR,7744,2403,5341,7744,0,ITH,ITH5,8,Emilia-Romagna
2021-01-15,VDA,218,82,136,218,0,ITC,ITC2,2,Valle d'Aosta / Vallée d'Aoste
2021-04-24,SAR,10359,4848,5511,8018,2341,ITG,ITG2,20,Sardegna
2021-04-25,SIC,21346,10180,11166,16370,4976,ITG,ITG1,19,Sicilia
2021-05-06,MOL,2654,1206,1448,2078,576,ITF,ITF2,14,Molise
2021-02-01,LAZ,5674,2176,3498,354,5320,ITI,ITI4,12,Lazio
2021-03-17,LIG,5553,2369,3184,2474,3079,ITC,ITC3,7,Liguria
2021-04-01,VDA,776,394,382,764,12,ITC,ITC2,2,Valle d'Aosta / Vallée d'Aoste
2021-01-07,LAZ,7744,2901,4843,7744,0,ITI,ITI4,12,Lazio
2021-01-25,PAB,487,183,304,3,484,ITH,ITH1,4,Provincia Autonoma Bolzano / Bozen
2021-02-10,FVG,1352,496,856,1266,86,ITH,ITH4,6,Friuli-Venezia Giulia
2021-04-03,ABR,5083,2219,2864,3487,1596,ITF,ITF1,13,Abruzzo
2021-01-17,PAB,2328,1044,1284,2317,11,ITH,ITH1,4,Provincia Autonoma Bolzano / Bozen
2021-04-11,TOS,3640,1677,1963,3485,155,ITI,ITI1,9,Toscana
2021-04-21,VEN,32244,13151,19093,16177,16067,ITH,ITH3,5,Veneto
2021-02-01,BAS,242,91,151,46,196,ITF,ITF5,17,Basilicata
2021-01-05,MAR,1562,586,976,1562,0,ITI,ITI3,11,Marche
2021-03-19,PIE,11018,4510,6508,4414,6604,ITC,ITC1,1,Piemonte
2021-05-13,CAM,55359,24802,30557,39390,15969,ITF,ITF3,15,Campania
2021-01-10,SAR,2183,750,1433,2183,0,ITG,ITG2,20,Sardegna
2021-01-26,FVG,1975,647,1328,215,1760,ITH,ITH4,6,Friuli-Venezia Giulia
2021-04-15,EMR,28929,13775,15154,19282,9647,ITH,ITH5,8,Emilia-Romagna
2021-04-27,PUG,26408,11954,14454,20813,5595,ITF,ITF4,16,Puglia
2021-04-29,MOL,2231,1140,1091,887,1344,ITF,ITF2,14,Molise
2021-05-04,LOM,86639,41006,45633,72369,14270,ITC,ITC4,3,Lombardia
2021-01-27,MAR,2118,780,1338,122,1996,ITI,ITI3,11,Marche
2021-01-28,VEN,9209,2662,6547,173,9036,ITH,ITH3,5,Veneto
2021-02-09,LIG,1936,689,1247,257,1679,ITC,ITC3,7,Liguria
2021-03-10,FVG,3358,1493,1865,1566,1792,ITH,ITH4,6,Friuli-Venezia Giulia
2021-03-27,FVG,4984,2560,2424,3573,1411,ITH,ITH4,6,Friuli-Venezia Giulia
2021-03-30,EMR,23272,10286,12986,18239,5033,ITH,ITH5,8,Emilia-Romagna
2021-04-27,PAT,3876,1864,2012,3809,67,ITH,ITH2,4,Provincia Autonoma Trento
2021-03-03,SIC,14668,6523,8145,11580,3088,ITG,ITG1,19,Sicilia
2021-04-01,BAS,2807,1134,1673,2092,715,ITF,ITF5,17,Basilicata
2021-04-09,LOM,52170,22279,29891,36175,15995,ITC,ITC4,3,Lombardia
2021-05-02,EMR,25435,11588,13847,13450,11985,ITH,ITH5,8,Emilia-Romagna
2021-05-05,VEN,43734,20981,22753,37233,6501,ITH,ITH3,5,Veneto
2021-02-04,UMB,733,226,507,25,708,ITI,ITI2,10,Umbria
2021-03-17,SAR,6556,2849,3707,4949,1607,ITG,ITG2,20,Sardegna
2021-03-20,LOM,32512,12152,20360,22660,9852,ITC,ITC4,3,Lombardia
2021-04-08,UMB,5831,2465,3366,4036,1795,ITI,ITI2,10,Umbria
2020-12-31,CAM,1490,811,679,1490,0,ITF,ITF3,15,Campania
2021-01-30,MOL,461,158,303,12,449,ITF,ITF2,14,Molise
2021-02-04,PAB,1958,593,1365,8,1950,ITH,ITH1,4,Provincia Autonoma Bolzano / Bozen
2021-02-21,CAL,608,286,322,531,77,ITF,ITF6,18,Calabria
2021-03-02,UMB,3641,1345,2296,3637,4,ITI,ITI2,10,Umbria
2021-04-24,FVG,6674,2945,3729,5431,1243,ITH,ITH4,6,Friuli-Venezia Giulia
2021-05-04,EMR,28528,13364,15164,14880,13648,ITH,ITH5,8,Emilia-Romagna
2021-05-09,VEN,34864,16037,18827,24809,10055,ITH,ITH3,5,Veneto
2021-05-13,LIG,13034,5847,7187,8821,4213,ITC,ITC3,7,Liguria
2021-01-04,SIC,8382,4177,4205,8382,0,ITG,ITG1,19,Sicilia
2021-01-29,EMR,10410,3497,6913,289,10121,ITH,ITH5,8,Emilia-Romagna
2021-02-01,SIC,6069,2681,3388,303,5766,ITG,ITG1,19,Sicilia
2021-03-25,MOL,1806,730,1076,1309,497,ITF,ITF2,14,Molise
2021-03-28,PIE,16040,6893,9147,8432,7608,ITC,ITC1,1,Piemonte
2021-04-07,TOS,35621,15287,20334,28381,7240,ITI,ITI1,9,Toscana
2021-04-24,VEN,24684,10804,13880,15616,9068,ITH,ITH3,5,Veneto
2021-04-08,VEN,32294,14337,17957,24419,7875,ITH,ITH3,5,Veneto
2021-04-24,PUG,29107,13240,15867,25155,3952,ITF,ITF4,16,Puglia
2021-03-11,LAZ,23778,10568,13210,17549,6229,ITI,ITI4,12,Lazio
2021-05-01,VDA,938,562,376,454,484,ITC,ITC2,2,Valle d'Aosta / Vallée d'Aoste
2021-05-11,MOL,1870,835,1035,1733,137,ITF,ITF2,14,Molise
2021-05-16,LOM,68401,32379,36022,36461,31940,ITC,ITC4,3,Lombardia
2021-02-15,LIG,2264,839,1425,1867,397,ITC,ITC3,7,Liguria
2021-04-05,LAZ,19771,8992,10779,13593,6178,ITI,ITI4,12,Lazio
2021-05-05,SAR,9895,4518,5377,7889,2006,ITG,ITG2,20,Sardegna
2021-03-12,BAS,1897,975,922,798,1099,ITF,ITF5,17,Basilicata
2021-03-19,CAM,11036,4870,6166,7165,3871,ITF,ITF3,15,Campania
2021-05-13,PIE,35085,17132,17953,20347,14738,ITC,ITC1,1,Piemonte
2021-01-28,PAB,871,308,563,10,861,ITH,ITH1,4,Provincia Autonoma Bolzano / Bozen
2021-03-14,PUG,3317,1429,1888,2506,811,ITF,ITF4,16,Puglia
2021-03-28,CAM,15551,7499,8052,13928,1623,ITF,ITF3,15,Campania
2021-05-08,PAT,3151,1721,1430,2734,417,ITH,ITH2,4,Provincia Autonoma Trento
2021-02-16,CAL,1532,642,890,1255,277,ITF,ITF6,18,Calabria
2021-03-18,MAR,3389,1475,1914,162,3227,ITI,ITI3,11,Marche
2021-03-22,PAB,1133,514,619,1129,4,ITH,ITH1,4,Provincia Autonoma Bolzano / Bozen
2021-01-05,ABR,1614,604,1010,1614,0,ITF,ITF1,13,Abruzzo
2021-01-19,BAS,199,84,115,199,0,ITF,ITF5,17,Basilicata
2021-02-16,PUG,3378,1451,1927,2734,644,ITF,ITF4,16,Puglia
2021-03-04,MOL,850,417,433,526,324,ITF,ITF2,14,Molise
2021-03-22,UMB,3559,1654,1905,2313,1246,ITI,ITI2,10,Umbria
2021-02-09,PAB,317,126,191,1,316,ITH,ITH1,4,Provincia Autonoma Bolzano / Bozen
2021-04-14,SIC,20388,9833,10555,11603,8785,ITG,ITG1,19,Sicilia
2021-04-21,FVG,7695,3438,4257,4015,3680,ITH,ITH4,6,Friuli-Venezia Giulia
2021-05-08,FVG,10226,4622,5604,5459,4767,ITH,ITH4,6,Friuli-Venezia Giulia
2021-01-08,PIE,5531,1761,3770,5531,0,ITC,ITC1,1,Piemonte
2021-04-23,SIC,28890,13846,15044,22944,5946,ITG,ITG1,19,Sicilia
2020-12-31,PIE,3909,1334,2575,3909,0,ITC,ITC1,1,Piemonte
2021-02-08,VDA,223,83,140,25,198,ITC,ITC2,2,Valle d'Aosta / Vallée d'Aoste
2021-03-31,UMB,3902,1733,2169,2215,1687,ITI,ITI2,10,Umbria
2021-02-12,EMR,5320,1679,3641,3917,1403,ITH,ITH5,8,Emilia-Romagna
2021-02-24,CAM,11789,4149,7640,11101,688,ITF,ITF3,15,Campania
2021-05-04,ABR,10693,5040,5653,7075,3618,ITF,ITF1,13,Abruzzo
2021-02-04,LIG,2816,985,1831,179,2637,ITC,ITC3,7,Liguria
2021-03-09,TOS,10672,4150,6522,5120,5552,ITI,ITI1,9,Toscana
2021-01-10,PAT,84,19,65,84,0,ITH,ITH2,4,Provincia Autonoma Trento
2021-01-14,MOL,646,239,407,646,0,ITF,ITF2,14,Molise
2021-02-25,MAR,3510,1434,2076,3331,179,ITI,ITI3,11,Marche
2021-03-14,SAR,607,376,231,607,0,ITG,ITG2,20,Sardegna
2021-02-20,LAZ,9204,4273,4931,8437,767,ITI,ITI4,12,Lazio
2021-04-06,CAM,24378,11423,12955,19857,4521,ITF,ITF3,15,Campania
2021-05-14,LIG,12879,5648,7231,8584,4295,ITC,ITC3,7,Liguria
2021-02-27,TOS,1976,749,1227,1074,902,ITI,ITI1,9,Toscana
2021-03-17,PAB,581,213,368,580,1,ITH,ITH1,4,Provincia Autonoma Bolzano / Bozen
2021-01-17,LIG,861,300,561,861,0,ITC,ITC3,7,Liguria
2021-02-28,LIG,1060,581,479,1051,9,ITC,ITC3,7,Liguria
2021-03-24,VDA,515,230,285,258,257,ITC,ITC2,2,Valle d'Aosta / Vallée d'Aoste
2021-04-06,PIE,20236,8808,11428,15040,5196,ITC,ITC1,1,Piemonte
2021-04-11,PAB,2720,1291,1429,2543,177,ITH,ITH1,4,Provincia Autonoma Bolzano / Bozen
2021-04-24,PAT,3507,1682,1825,3494,13,ITH,ITH2,4,Provincia Autonoma Trento
2020-12-30,LIG,12,5,7,12,0,ITC,ITC3,7,Liguria
2021-01-16,BAS,721,304,417,721,0,ITF,ITF5,17,Basilicata
2021-01-25,TOS,5126,1896,3230,248,4878,ITI,ITI1,9,Toscana
2021-01-28,UMB,1247,394,853,19,1228,ITI,ITI2,10,Umbria
2021-04-21,SAR,12066,5552,6514,6535,5531,ITG,ITG2,20,Sardegna
2021-05-14,CAM,60793,27456,33337,36311,24482,ITF,ITF3,15,Campania
2021-05-19,PIE,26112,12015,14097,16563,9549,ITC,ITC1,1,Piemonte
2020-12-27,MAR,200,97,103,200,0,ITI,ITI3,11,Marche
2021-01-10,VEN,5032,1671,3361,5032,0,ITH,ITH3,5,Veneto
2021-01-18,ABR,122,48,74,46,76,ITF,ITF1,13,Abruzzo
2021-02-28,CAM,10412,3206,7206,8512,1900,ITF,ITF3,15,Campania
2021-03-01,EMR,10085,3574,6511,7832,2253,ITH,ITH5,8,Emilia-Romagna
2021-03-14,PAT,107,65,42,20,87,ITH,ITH2,4,Provincia Autonoma Trento
2021-01-29,LOM,13439,4115,9324,655,12784,ITC,ITC4,3,Lombardia
2021-01-31,PAT,75,15,60,1,74,ITH,ITH2,4,Provincia Autonoma Trento
2021-04-12,TOS,2609,1182,1427,1955,654,ITI,ITI1,9,Toscana
2021-01-10,UMB,1070,277,793,1070,0,ITI,ITI2,10,Umbria
2021-02-07,PIE,3087,974,2113,445,2642,ITC,ITC1,1,Piemonte
2021-04-05,SIC,8024,3959,4065,6584,1440,ITG,ITG1,19,Sicilia
2021-04-30,EMR,36469,16715,19754,21691,14778,ITH,ITH5,8,Emilia-Romagna
2021-02-24,LOM,14675,5928,8747,13747,928,ITC,ITC4,3,Lombardia
2021-04-26,CAM,33983,16627,17356,28360,5623,ITF,ITF3,15,Campania
2021-01-23,LIG,809,295,514,153,656,ITC,ITC3,7,Liguria
2021-03-14,FVG,1395,547,848,1143,252,ITH,ITH4,6,Friuli-Venezia Giulia
2021-04-12,PIE,22909,10343,12566,19926,2983,ITC,ITC1,1,Piemonte
2021-01-17,CAM,1155,551,604,702,453,ITF,ITF3,15,Campania
2021-02-21,CAM,5834,2239,3595,5609,225,ITF,ITF3,15,Campania
2021-03-17,UMB,3331,1313,2018,1859,1472,ITI,ITI2,10,Umbria
2021-05-17,LIG,11763,5334,6429,8472,3291,ITC,ITC3,7,Liguria
2021-01-15,ABR,379,149,230,379,0,ITF,ITF1,13,Abruzzo
2021-02-02,VDA,272,70,202,2,270,ITC,ITC2,2,Valle d'Aosta / Vallée d'Aoste
2021-04-01,ABR,5541,2457,3084,3454,2087,ITF,ITF1,13,Abruzzo
2021-04-06,LIG,13169,5856,7313,10929,2240,ITC,ITC3,7,Liguria
2021-04-26,LIG,10425,4904,5521,7810,2615,ITC,ITC3,7,Liguria
2021-05-03,LAZ,38983,17592,21391,26510,12473,ITI,ITI4,12,Lazio
2021-04-08,SAR,13424,5922,7502,8307,5117,ITG,ITG2,20,Sardegna
2021-05-04,VDA,1135,510,625,462,673,ITC,ITC2,2,Valle d'Aosta / Vallée d'Aoste
2021-01-02,TOS,3497,1096,2401,3497,0,ITI,ITI1,9,Toscana
2021-02-10,PAT,851,291,560,509,342,ITH,ITH2,4,Provincia Autonoma Trento
2021-05-03,TOS,11923,5503,6420,10607,1316,ITI,ITI1,9,Toscana
2021-02-08,ABR,1197,396,801,487,710,ITF,ITF1,13,Abruzzo
2021-05-05,TOS,29975,13347,16628,15618,14357,ITI,ITI1,9,Toscana
2021-02-07,LIG,407,153,254,2,405,ITC,ITC3,7,Liguria
2021-02-20,LOM,9438,3901,5537,9139,299,ITC,ITC4,3,Lombardia
2021-05-10,CAM,35389,16365,19024,25496,9893,ITF,ITF3,15,Campania
2021-02-17,EMR,6538,2764,3774,5765,773,ITH,ITH5,8,Emilia-Romagna
2021-02-24,ABR,3302,1439,1863,3126,176,ITF,ITF1,13,Abruzzo
2021-05-19,FVG,4900,2446,2454,4100,800,ITH,ITH4,6,Friuli-Venezia Giulia
2021-05-09,LAZ,37515,17247,20268,26253,11262,ITI,ITI4,12,Lazio
2021-01-29,ABR,1386,449,937,74,1312,ITF,ITF1,13,Abruzzo
2021-03-12,CAL,5079,2431,2648,4036,1043,ITF,ITF6,18,Calabria
2021-05-01,TOS,23288,10049,13239,14118,9170,ITI,ITI1,9,Toscana
2021-02-18,SAR,1878,732,1146,1814,64,ITG,ITG2,20,Sardegna
2021-01-21,CAM,2092,1115,977,676,1416,ITF,ITF3,15,Campania
2021-02-16,EMR,5766,2443,3323,5235,531,ITH,ITH5,8,Emilia-Romagna
2021-02-25,PAB,1498,549,949,1497,1,ITH,ITH1,4,Provincia Autonoma Bolzano / Bozen
2021-05-12,PUG,35742,15857,19885,23485,12257,ITF,ITF4,16,Puglia
2021-01-03,LAZ,5250,1972,3278,5250,0,ITI,ITI4,12,Lazio
2021-01-12,FVG,2260,713,1547,2260,0,ITH,ITH4,6,Friuli-Venezia Giulia
2021-03-13,LAZ,21414,8408,13006,15520,5894,ITI,ITI4,12,Lazio
2021-03-29,CAM,18946,9134,9812,17400,1546,ITF,ITF3,15,Campania
2021-03-31,EMR,25124,10947,14177,19667,5457,ITH,ITH5,8,Emilia-Romagna
2021-05-11,CAL,15096,7301,7795,10325,4771,ITF,ITF6,18,Calabria
2021-02-18,EMR,7039,2892,4147,6456,583,ITH,ITH5,8,Emilia-Romagna
2021-03-29,CAL,5627,2380,3247,3873,1754,ITF,ITF6,18,Calabria
2021-04-23,LIG,14671,6639,8032,8551,6120,ITC,ITC3,7,Liguria
2021-05-12,TOS,34016,15485,18531,14132,19884,ITI,ITI1,9,Toscana
2021-02-03,LAZ,6489,2488,4001,965,5524,ITI,ITI4,12,Lazio
2021-03-05,PIE,15265,5958,9307,11447,3818,ITC,ITC1,1,Piemonte
2021-03-23,MAR,5789,2529,3260,2262,3527,ITI,ITI3,11,Marche
2021-04-05,LIG,3976,1751,2225,2327,1649,ITC,ITC3,7,Liguria
2021-01-08,SAR,3258,1184,2074,3258,0,ITG,ITG2,20,Sardegna
2021-05-11,EMR,34944,16393,18551,27703,7241,ITH,ITH5,8,Emilia-Romagna
2021-05-14,SIC,51891,24311,27580,36058,15833,ITG,ITG1,19,Sicilia
2021-03-18,PIE,11742,4798,6944,4029,7713,ITC,ITC1,1,Piemonte
2021-05-09,MAR,8765,3982,4783,3641,5124,ITI,ITI3,11,Marche
2021-01-21,PIE,6881,2314,4567,3385,3496,ITC,ITC1,1,Piemonte
2021-04-02,PAT,2787,1143,1644,2113,674,ITH,ITH2,4,Provincia Autonoma Trento
2021-04-30,BAS,5283,2373,2910,4117,1166,ITF,ITF5,17,Basilicata
2021-01-01,PAT,213,50,163,213,0,ITH,ITH2,4,Provincia Autonoma Trento
2021-03-03,PAB,1178,393,785,1165,13,ITH,ITH1,4,Provincia Autonoma Bolzano / Bozen
2021-01-03,SIC,4698,2457,2241,4698,0,ITG,ITG1,19,Sicilia
2021-04-21,BAS,3918,1834,2084,2268,1650,ITF,ITF5,17,Basilicata
2021-02-27,UMB,1658,354,1304,1642,16,ITI,ITI2,10,Umbria
2021-03-24,TOS,19654,7973,11681,10198,9456,ITI,ITI1,9,Toscana
2021-04-07,VDA,908,473,435,679,229,ITC,ITC2,2,Valle d'Aosta / Vallée d'Aoste
2021-05-04,BAS,4132,1989,2143,3609,523,ITF,ITF5,17,Basilicata
2021-01-12,PAT,505,158,347,505,0,ITH,ITH2,4,Provincia Autonoma Trento
2021-03-09,CAL,5820,3032,2788,4844,976,ITF,ITF6,18,Calabria
2021-04-11,PIE,20822,9315,11507,18661,2161,ITC,ITC1,1,Piemonte
2021-02-03,SIC,6107,2860,3247,756,5351,ITG,ITG1,19,Sicilia
2021-03-24,LAZ,25886,11300,14586,19649,6237,ITI,ITI4,12,Lazio
2020-12-31,LIG,989,354,635,989,0,ITC,ITC3,7,Liguria
2021-04-06,UMB,5290,2169,3121,2901,2389,ITI,ITI2,10,Umbria
2021-03-03,UMB,4438,1773,2665,3727,711,ITI,ITI2,10,Umbria
2021-03-23,LAZ,23495,10225,13270,16919,6576,ITI,ITI4,12,Lazio
2021-04-02,PUG,12577,5758,6819,8059,4518,ITF,ITF4,16,Puglia
2021-05-17,UMB,6299,3022,3277,4158,2141,ITI,ITI2,10,Umbria
2021-02-23,PIE,9233,3713,5520,8653,580,ITC,ITC1,1,Piemonte
2021-01-20,MAR,398,100,298,384,14,ITI,ITI3,11,Marche
2021-01-26,SIC,9481,4667,4814,262,9219,ITG,ITG1,19,Sicilia
2021-03-09,FVG,3855,1589,2266,1108,2747,ITH,ITH4,6,Friuli-Venezia Giulia
2021-03-21,UMB,665,330,335,665,0,ITI,ITI2,10,Umbria
2021-04-01,MOL,1454,662,792,729,725,ITF,ITF2,14,Molise
2021-04-04,SAR,1,0,1,0,1,ITG,ITG2,20,Sardegna
2021-04-11,ABR,5330,2606,2724,4847,483,ITF,ITF1,13,Abruzzo
2021-03-06,MOL,1728,807,921,1569,159,ITF,ITF2,14,Molise
2021-03-11,LIG,6352,3054,3298,4346,2006,ITC,ITC3,7,Liguria
2021-03-14,BAS,1008,477,531,539,469,ITF,ITF5,17,Basilicata
2021-05-13,FVG,10916,5247,5669,8945,1971,ITH,ITH4,6,Friuli-Venezia Giulia
2021-01-10,MAR,1737,699,1038,1737,0,ITI,ITI3,11,Marche
2021-02-12,BAS,775,332,443,744,31,ITF,ITF5,17,Basilicata
2021-03-22,VDA,560,205,355,333,227,ITC,ITC2,2,Valle d'Aosta / Vallée d'Aoste
2021-03-24,MAR,7031,2982,4049,3363,3668,ITI,ITI3,11,Marche
2021-03-29,LOM,40001,15508,24493,25181,14820,ITC,ITC4,3,Lombardia
2021-01-01,PUG,146,60,86,146,0,ITF,ITF4,16,Puglia
2021-04-09,SIC,20535,10001,10534,11389,9146,ITG,ITG1,19,Sicilia
2021-04-25,PAB,3069,1496,1573,2398,671,ITH,ITH1,4,Provincia Autonoma Bolzano / Bozen
2021-01-12,PUG,4212,1772,2440,4212,0,ITF,ITF4,16,Puglia
2021-03-23,TOS,9088,4099,4989,6816,2272,ITI,ITI1,9,Toscana
2021-02-06,LAZ,6135,2474,3661,817,5318,ITI,ITI4,12,Lazio
2021-02-16,LOM,9542,3086,6456,9086,456,ITC,ITC4,3,Lombardia
2021-02-27,VEN,8986,2691,6295,8139,847,ITH,ITH3,5,Veneto
2021-03-29,FVG,6873,3000,3873,5293,1580,ITH,ITH4,6,Friuli-Venezia Giulia
2021-04-16,LAZ,34298,15635,18663,22244,12054,ITI,ITI4,12,Lazio
2021-05-16,ABR,9576,4136,5440,5765,3811,ITF,ITF1,13,Abruzzo
2021-01-04,LIG,2617,855,1762,2617,0,ITC,ITC3,7,Liguria
2021-03-09,PAT,1580,589,991,937,643,ITH,ITH2,4,Provincia Autonoma Trento
2021-04-16,SIC,28724,14414,14310,20348,8376,ITG,ITG1,19,Sicilia
2021-03-04,PUG,15067,5876,9191,13679,1388,ITF,ITF4,16,Puglia
2021-04-24,BAS,4544,2197,2347,3531,1013,ITF,ITF5,17,Basilicata
2021-01-09,LOM,12410,4573,7837,12410,0,ITC,ITC4,3,Lombardia
2021-02-11,PAT,1132,365,767,796,336,ITH,ITH2,4,Provincia Autonoma Trento
2021-02-26,PIE,12292,4932,7360,11556,736,ITC,ITC1,1,Piemonte
2021-01-19,LAZ,4768,1954,2814,4314,454,ITI,ITI4,12,Lazio
2021-02-18,UMB,1496,582,914,1030,466,ITI,ITI2,10,Umbria
2021-04-25,MOL,787,393,394,558,229,ITF,ITF2,14,Molise
2021-05-03,LIG,13265,5920,7345,6454,6811,ITC,ITC3,7,Liguria
2021-05-09,VDA,574,287,287,444,130,ITC,ITC2,2,Valle d'Aosta / Vallée d'Aoste
2021-03-03,MOL,672,316,356,590,82,ITF,ITF2,14,Molise
2021-05-14,MAR,13492,6217,7275,6720,6772,ITI,ITI3,11,Marche
2021-02-05,TOS,5749,2245,3504,1924,3825,ITI,ITI1,9,Toscana
2021-02-06,SIC,5011,2188,2823,1462,3549,ITG,ITG1,19,Sicilia
2021-02-17,ABR,2071,948,1123,1789,282,ITF,ITF1,13,Abruzzo
2021-04-25,LIG,1936,921,1015,1521,415,ITC,ITC3,7,Liguria
2021-01-25,PIE,6214,1938,4276,983,5231,ITC,ITC1,1,Piemonte
2021-04-12,PAT,3077,1401,1676,2581,496,ITH,ITH2,4,Provincia Autonoma Trento
2021-03-15,LIG,7302,3076,4226,4598,2704,ITC,ITC3,7,Liguria
2021-03-18,CAM,12172,5378,6794,5984,6188,ITF,ITF3,15,Campania
2021-05-11,SAR,8628,3980,4648,6298,2330,ITG,ITG2,20,Sardegna
2021-01-17,VDA,131,56,75,131,0,ITC,ITC2,2,Valle d'Aosta / Vallée d'Aoste
2021-01-08,UMB,1190,345,845,1190,0,ITI,ITI2,10,Umbria
2021-03-05,CAM,16478,6348,10130,9817,6661,ITF,ITF3,15,Campania
2021-03-20,ABR,4722,2153,2569,2559,2163,ITF,ITF1,13,Abruzzo
2020-12-31,UMB,322,127,195,322,0,ITI,ITI2,10,Umbria
2021-03-19,FVG,3233,1339,1894,1301,1932,ITH,ITH4,6,Friuli-Venezia Giulia
2021-02-26,CAM,13339,4230,9109,12004,1335,ITF,ITF3,15,Campania
2021-02-10,VDA,248,77,171,141,107,ITC,ITC2,2,Valle d'Aosta / Vallée d'Aoste
2021-02-18,PAB,1839,457,1382,1832,7,ITH,ITH1,4,Provincia Autonoma Bolzano / Bozen
2021-02-21,LIG,869,491,378,865,4,ITC,ITC3,7,Liguria
2021-02-27,EMR,10965,3999,6966,9227,1738,ITH,ITH5,8,Emilia-Romagna
2021-03-28,FVG,4807,2271,2536,4667,140,ITH,ITH4,6,Friuli-Venezia Giulia
2021-01-07,LOM,11761,3636,8125,11761,0,ITC,ITC4,3,Lombardia
2021-01-16,MOL,420,166,254,420,0,ITF,ITF2,14,Molise
2021-01-25,ABR,1603,632,971,19,1584,ITF,ITF1,13,Abruzzo
2021-02-27,SAR,1921,647,1274,1366,555,ITG,ITG2,20,Sardegna
2021-02-05,LAZ,7277,2962,4315,1185,6092,ITI,ITI4,12,Lazio
2021-02-11,TOS,5383,2021,3362,5141,242,ITI,ITI1,9,Toscana
2021-04-11,UMB,3102,1503,1599,3053,49,ITI,ITI2,10,Umbria
2021-05-10,FVG,7782,3440,4342,6255,1527,ITH,ITH4,6,Friuli-Venezia Giulia
2021-01-07,CAM,8910,4166,4744,8910,0,ITF,ITF3,15,Campania
2021-01-08,PAB,1521,479,1042,1521,0,ITH,ITH1,4,Provincia Autonoma Bolzano / Bozen
2021-04-04,VEN,7776,3531,4245,6625,1151,ITH,ITH3,5,Veneto
2020-12-31,PAB,912,518,394,912,0,ITH,ITH1,4,Provincia Autonoma Bolzano / Bozen
2021-01-25,PUG,3822,1679,2143,423,3399,ITF,ITF4,16,Puglia
2021-02-02,TOS,3742,1475,2267,195,3547,ITI,ITI1,9,Toscana
2021-02-11,PUG,3699,1402,2297,2422,1277,ITF,ITF4,16,Puglia
2021-04-03,MOL,1766,848,918,1732,34,ITF,ITF2,14,Molise
2021-02-07,MAR,1868,734,1134,344,1524,ITI,ITI3,11,Marche
2021-02-19,PAB,2252,512,1740,2241,11,ITH,ITH1,4,Provincia Autonoma Bolzano / Bozen
2021-03-23,VDA,379,150,229,245,134,ITC,ITC2,2,Valle d'Aosta / Vallée d'Aoste
2021-04-10,TOS,11721,5348,6373,10975,746,ITI,ITI1,9,Toscana
2021-04-26,VDA,715,327,388,545,170,ITC,ITC2,2,Valle d'Aosta / Vallée d'Aoste
2021-04-29,PUG,25640,11855,13785,19025,6615,ITF,ITF4,16,Puglia
2021-04-29,CAL,11585,5630,5955,8282,3303,ITF,ITF6,18,Calabria
2021-05-15,TOS,29210,13794,15416,23519,5691,ITI,ITI1,9,Toscana
2021-05-17,EMR,29753,14162,15591,20547,9206,ITH,ITH5,8,Emilia-Romagna
2021-02-04,SAR,2271,816,1455,916,1355,ITG,ITG2,20,Sardegna
2021-02-20,CAL,1357,735,622,1042,315,ITF,ITF6,18,Calabria
2021-03-03,PIE,12119,4644,7475,11300,819,ITC,ITC1,1,Piemonte
2021-01-09,EMR,9945,3440,6505,9945,0,ITH,ITH5,8,Emilia-Romagna
2021-02-23,UMB,1693,658,1035,1651,42,ITI,ITI2,10,Umbria
2021-02-27,ABR,2810,1337,1473,2544,266,ITF,ITF1,13,Abruzzo
2021-02-01,CAL,2495,1192,1303,243,2252,ITF,ITF6,18,Calabria
2021-03-17,BAS,1451,608,843,27,1424,ITF,ITF5,17,Basilicata
2021-04-05,UMB,4250,1728,2522,2195,2055,ITI,ITI2,10,Umbria
2021-04-12,PUG,29044,13683,15361,26220,2824,ITF,ITF4,16,Puglia
2021-04-30,MOL,2914,1542,1372,828,2086,ITF,ITF2,14,Molise
2021-04-12,ABR,6227,2950,3277,5053,1174,ITF,ITF1,13,Abruzzo
2021-01-08,EMR,10837,3570,7267,10837,0,ITH,ITH5,8,Emilia-Romagna
2021-01-19,SIC,1278,524,754,1095,183,ITG,ITG1,19,Sicilia
2021-02-18,VEN,5828,2455,3373,5764,64,ITH,ITH3,5,Veneto
2021-04-05,MOL,389,188,201,290,99,ITF,ITF2,14,Molise
2021-01-06,MOL,689,260,429,689,0,ITF,ITF2,14,Molise
2021-02-24,EMR,9323,3556,5767,8443,880,ITH,ITH5,8,Emilia-Romagna
2021-01-01,PIE,1038,395,643,1038,0,ITC,ITC1,1,Piemonte
2021-04-08,MAR,7523,3286,4237,7196,327,ITI,ITI3,11,Marche
2021-05-11,VEN,32594,16252,16342,28052,4542,ITH,ITH3,5,Veneto
2021-01-17,FVG,1716,523,1193,1716,0,ITH,ITH4,6,Friuli-Venezia Giulia
2021-04-11,LOM,32176,13934,18242,24784,7392,ITC,ITC4,3,Lombardia
2021-04-13,SIC,19917,9689,10228,11082,8835,ITG,ITG1,19,Sicilia
2021-05-11,LOM,86392,41269,45123,60495,25897,ITC,ITC4,3,Lombardia
2021-03-09,PUG,13183,5747,7436,11176,2007,ITF,ITF4,16,Puglia
2021-04-26,FVG,5442,2444,2998,3793,1649,ITH,ITH4,6,Friuli-Venezia Giulia
2021-02-20,PAT,407,245,162,123,284,ITH,ITH2,4,Provincia Autonoma Trento
2021-02-07,SIC,2349,997,1352,675,1674,ITG,ITG1,19,Sicilia
2021-03-21,CAL,4355,1882,2473,2655,1700,ITF,ITF6,18,Calabria
2021-01-13,LIG,2755,1014,1741,2755,0,ITC,ITC3,7,Liguria
2021-02-25,VEN,7899,3339,4560,7294,605,ITH,ITH3,5,Veneto
2021-03-16,PIE,10519,4268,6251,4463,6056,ITC,ITC1,1,Piemonte
2021-01-04,MOL,314,131,183,314,0,ITF,ITF2,14,Molise
2021-03-12,PUG,13921,6105,7816,9996,3925,ITF,ITF4,16,Puglia
2021-04-08,SIC,16795,8287,8508,8312,8483,ITG,ITG1,19,Sicilia
2021-01-05,MOL,449,180,269,449,0,ITF,ITF2,14,Molise
2021-03-06,PIE,13992,5210,8782,11203,2789,ITC,ITC1,1,Piemonte
2021-05-02,SIC,24656,11447,13209,18055,6601,ITG,ITG1,19,Sicilia
2021-02-06,MOL,429,179,250,29,400,ITF,ITF2,14,Molise
2021-02-27,PAT,1026,456,570,605,421,ITH,ITH2,4,Provincia Autonoma Trento
2021-03-21,FVG,2602,937,1665,2193,409,ITH,ITH4,6,Friuli-Venezia Giulia
2021-01-30,LIG,1661,567,1094,25,1636,ITC,ITC3,7,Liguria
2021-02-19,EMR,7327,3010,4317,6813,514,ITH,ITH5,8,Emilia-Romagna
2021-04-16,MOL,2411,1027,1384,1184,1227,ITF,ITF2,14,Molise
2021-04-28,EMR,32627,15067,17560,19746,12881,ITH,ITH5,8,Emilia-Romagna
2021-05-11,ABR,10655,5059,5596,5828,4827,ITF,ITF1,13,Abruzzo
2021-02-01,PAT,1220,335,885,92,1128,ITH,ITH2,4,Provincia Autonoma Trento
2021-02-16,BAS,905,377,528,807,98,ITF,ITF5,17,Basilicata
2021-04-18,PIE,22932,10813,12119,20178,2754,ITC,ITC1,1,Piemonte
2021-05-11,BAS,2646,1349,1297,1613,1033,ITF,ITF5,17,Basilicata
2021-05-08,TOS,29063,13076,15987,13673,15390,ITI,ITI1,9,Toscana
2021-04-20,UMB,5435,2353,3082,3488,1947,ITI,ITI2,10,Umbria
2021-05-07,PIE,32759,15478,17281,18791,13968,ITC,ITC1,1,Piemonte
2021-03-16,SAR,4374,1949,2425,3452,922,ITG,ITG2,20,Sardegna
2021-05-03,EMR,27789,13128,14661,16924,10865,ITH,ITH5,8,Emilia-Romagna
2021-02-18,ABR,2288,933,1355,2158,130,ITF,ITF1,13,Abruzzo
2021-02-25,UMB,1336,497,839,1284,52,ITI,ITI2,10,Umbria
2021-04-17,CAM,36161,17501,18660,24655,11506,ITF,ITF3,15,Campania
2021-04-28,SAR,8728,4121,4607,5035,3693,ITG,ITG2,20,Sardegna
2021-04-30,CAL,14663,7211,7452,10578,4085,ITF,ITF6,18,Calabria
2021-03-13,TOS,9274,3300,5974,5312,3962,ITI,ITI1,9,Toscana
2021-04-23,MOL,2048,881,1167,1389,659,ITF,ITF2,14,Molise
2021-04-15,LAZ,31825,14274,17551,21029,10796,ITI,ITI4,12,Lazio
2021-03-02,SIC,14881,6367,8514,12072,2809,ITG,ITG1,19,Sicilia
2021-01-28,MAR,2086,725,1361,165,1921,ITI,ITI3,11,Marche
2021-02-06,LIG,1892,768,1124,145,1747,ITC,ITC3,7,Liguria
2021-02-14,SAR,539,263,276,537,2,ITG,ITG2,20,Sardegna
2021-03-16,PAB,1290,532,758,124,1166,ITH,ITH1,4,Provincia Autonoma Bolzano / Bozen
2021-04-12,FVG,7253,3181,4072,6122,1131,ITH,ITH4,6,Friuli-Venezia Giulia
2021-04-16,LIG,11977,5283,6694,10166,1811,ITC,ITC3,7,Liguria
2021-04-05,EMR,14855,6807,8048,11962,2893,ITH,ITH5,8,Emilia-Romagna
2021-03-26,VEN,29537,13115,16422,24071,5466,ITH,ITH3,5,Veneto
2021-04-05,SAR,2036,784,1252,2035,1,ITG,ITG2,20,Sardegna
2021-01-09,ABR,1483,565,918,1483,0,ITF,ITF1,13,Abruzzo
2021-02-27,BAS,1991,859,1132,1827,164,ITF,ITF5,17,Basilicata
2021-03-21,LOM,23576,8549,15027,18315,5261,ITC,ITC4,3,Lombardia
2021-04-22,PIE,27596,12697,14899,20906,6690,ITC,ITC1,1,Piemonte
2021-01-08,ABR,1525,507,1018,1525,0,ITF,ITF1,13,Abruzzo
2021-02-19,ABR,3300,1551,1749,3200,100,ITF,ITF1,13,Abruzzo
2021-02-20,PUG,2968,1079,1889,2712,256,ITF,ITF4,16,Puglia
2021-03-25,SIC,20528,9540,10988,14989,5539,ITG,ITG1,19,Sicilia
2021-01-07,PUG,5716,2457,3259,5716,0,ITF,ITF4,16,Puglia
2021-03-12,PAT,2493,931,1562,1688,805,ITH,ITH2,4,Provincia Autonoma Trento
2021-03-25,LAZ,26912,11509,15403,20313,6599,ITI,ITI4,12,Lazio
2021-01-08,VEN,9404,2836,6568,9404,0,ITH,ITH3,5,Veneto
2021-01-25,FVG,1584,568,1016,194,1390,ITH,ITH4,6,Friuli-Venezia Giulia
2021-01-06,BAS,294,129,165,294,0,ITF,ITF5,17,Basilicata
2021-02-01,PUG,3964,1659,2305,375,3589,ITF,ITF4,16,Puglia
2021-02-03,MOL,731,249,482,338,393,ITF,ITF2,14,Molise
2021-03-01,BAS,548,285,263,382,166,ITF,ITF5,17,Basilicata
2021-01-26,PAB,810,291,519,1,809,ITH,ITH1,4,Provincia Autonoma Bolzano / Bozen
2021-04-04,PIE,9254,4059,5195,6541,2713,ITC,ITC1,1,Piemonte
2020-12-27,PIE,913,369,544,913,0,ITC,ITC1,1,Piemonte
2021-02-14,VEN,125,56,69,112,13,ITH,ITH3,5,Veneto
2021-02-17,BAS,1135,493,642,1059,76,ITF,ITF5,17,Basilicata
2021-04-09,MOL,2296,1240,1056,2105,191,ITF,ITF2,14,Molise
2021-02-04,BAS,1095,442,653,63,1032,ITF,ITF5,17,Basilicata
2021-02-19,SAR,1499,473,1026,1443,56,ITG,ITG2,20,Sardegna
2021-04-01,PAB,2786,1407,1379,2642,144,ITH,ITH1,4,Provincia Autonoma Bolzano / Bozen
2021-01-07,ABR,1603,552,1051,1603,0,ITF,ITF1,13,Abruzzo
2021-01-07,PAT,1270,310,960,1270,0,ITH,ITH2,4,Provincia Autonoma Trento
2021-01-22,PIE,3866,1249,2617,2525,1341,ITC,ITC1,1,Piemonte
2021-02-15,VDA,264,136,128,229,35,ITC,ITC2,2,Valle d'Aosta / Vallée d'Aoste
2021-03-16,VEN,12517,5347,7170,6902,5615,ITH,ITH3,5,Veneto
2021-04-13,LIG,13052,5860,7192,11033,2019,ITC,ITC3,7,Liguria
2021-01-19,LIG,1371,438,933,1281,90,ITC,ITC3,7,Liguria
2021-03-06,CAM,16309,6753,9556,10641,5668,ITF,ITF3,15,Campania
2021-04-25,EMR,22313,10216,12097,14809,7504,ITH,ITH5,8,Emilia-Romagna
2021-05-07,CAM,59673,29163,30510,43748,15925,ITF,ITF3,15,Campania
2021-01-03,PAB,41,16,25,41,0,ITH,ITH1,4,Provincia Autonoma Bolzano / Bozen
2021-01-21,FVG,895,345,550,1,894,ITH,ITH4,6,Friuli-Venezia Giulia
2021-04-22,CAM,33930,16524,17406,21529,12401,ITF,ITF3,15,Campania
2021-05-19,VDA,720,357,363,159,561,ITC,ITC2,2,Valle d'Aosta / Vallée d'Aoste
2021-03-21,CAM,9984,4592,5392,7594,2390,ITF,ITF3,15,Campania
2021-03-26,SAR,8087,3178,4909,6562,1525,ITG,ITG2,20,Sardegna
2021-03-08,CAM,14538,6716,7822,9762,4776,ITF,ITF3,15,Campania
2021-03-10,CAM,15246,7377,7869,8413,6833,ITF,ITF3,15,Campania
2021-05-18,TOS,28459,14024,14435,19886,8573,ITI,ITI1,9,Toscana
2021-01-15,MOL,538,242,296,538,0,ITF,ITF2,14,Molise
2021-02-23,CAM,11002,3387,7615,10477,525,ITF,ITF3,15,Campania
2021-02-25,MOL,541,239,302,473,68,ITF,ITF2,14,Molise
2021-04-25,UMB,4362,1685,2677,4280,82,ITI,ITI2,10,Umbria
2021-02-09,EMR,4152,1247,2905,2306,1846,ITH,ITH5,8,Emilia-Romagna
2021-03-03,CAM,13919,5492,8427,7289,6630,ITF,ITF3,15,Campania
2021-03-26,LOM,41122,15594,25528,28091,13031,ITC,ITC4,3,Lombardia
2021-03-28,VDA,522,212,310,521,1,ITC,ITC2,2,Valle d'Aosta / Vallée d'Aoste
2021-03-30,SIC,14595,6759,7836,9769,4826,ITG,ITG1,19,Sicilia
2021-01-06,SAR,1615,549,1066,1615,0,ITG,ITG2,20,Sardegna
2021-02-25,SAR,2899,1255,1644,2294,605,ITG,ITG2,20,Sardegna
2021-04-04,LOM,7617,3232,4385,3718,3899,ITC,ITC4,3,Lombardia
2021-05-03,VEN,40468,19713,20755,34053,6415,ITH,ITH3,5,Veneto
2021-01-03,LIG,734,230,504,734,0,ITC,ITC3,7,Liguria
2021-02-19,UMB,743,293,450,526,217,ITI,ITI2,10,Umbria
2021-03-27,LAZ,26011,10396,15615,19543,6468,ITI,ITI4,12,Lazio
2020-12-29,SAR,57,32,25,57,0,ITG,ITG2,20,Sardegna
2021-01-18,LAZ,6264,2555,3709,5286,978,ITI,ITI4,12,Lazio
2021-05-03,SAR,8174,3813,4361,6577,1597,ITG,ITG2,20,Sardegna
2021-02-16,ABR,1918,842,1076,1906,12,ITF,ITF1,13,Abruzzo
2021-04-17,PIE,30311,14087,16224,27033,3278,ITC,ITC1,1,Piemonte
2021-02-23,FVG,2615,1252,1363,2437,178,ITH,ITH4,6,Friuli-Venezia Giulia
2021-03-19,VDA,322,85,237,286,36,ITC,ITC2,2,Valle d'Aosta / Vallée d'Aoste
2021-05-10,CAL,13117,6083,7034,7727,5390,ITF,ITF6,18,Calabria
2020-12-29,LOM,104,44,60,104,0,ITC,ITC4,3,Lombardia
2021-01-18,TOS,1119,636,483,1021,98,ITI,ITI1,9,Toscana
2021-02-26,LOM,18364,7551,10813,16514,1850,ITC,ITC4,3,Lombardia
2021-03-31,BAS,3095,1258,1837,2313,782,ITF,ITF5,17,Basilicata
2021-04-30,CAM,42224,20126,22098,25780,16444,ITF,ITF3,15,Campania
2021-02-26,FVG,3733,2091,1642,3585,148,ITH,ITH4,6,Friuli-Venezia Giulia
2021-01-11,MAR,1176,411,765,1176,0,ITI,ITI3,11,Marche
2021-01-30,MAR,1905,668,1237,29,1876,ITI,ITI3,11,Marche
2021-02-08,PUG,3992,1610,2382,1597,2395,ITF,ITF4,16,Puglia
2021-02-14,EMR,1401,378,1023,1281,120,ITH,ITH5,8,Emilia-Romagna
2021-02-22,TOS,9818,4254,5564,9541,277,ITI,ITI1,9,Toscana
2021-04-28,UMB,5325,2307,3018,2943,2382,ITI,ITI2,10,Umbria
2021-05-04,CAL,16276,7479,8797,11653,4623,ITF,ITF6,18,Calabria
2021-01-20,SIC,818,414,404,573,245,ITG,ITG1,19,Sicilia
2021-03-12,PIE,13947,5184,8763,11012,2935,ITC,ITC1,1,Piemonte
2021-05-02,LAZ,32613,14327,18286,23252,9361,ITI,ITI4,12,Lazio
2021-01-25,PAT,817,215,602,23,794,ITH,ITH2,4,Provincia Autonoma Trento
2021-01-27,TOS,4834,1572,3262,206,4628,ITI,ITI1,9,Toscana
2021-04-13,PAB,2391,1130,1261,2384,7,ITH,ITH1,4,Provincia Autonoma Bolzano / Bozen
2021-04-28,PAB,2458,1300,1158,2455,3,ITH,ITH1,4,Provincia Autonoma Bolzano / Bozen
2021-04-07,MAR,7811,3435,4376,7476,335,ITI,ITI3,11,Marche
2021-05-05,MAR,11623,5288,6335,5215,6408,ITI,ITI3,11,Marche
2021-02-10,TOS,4263,1281,2982,3740,523,ITI,ITI1,9,Toscana
2021-04-20,LIG,14214,6506,7708,9865,4349,ITC,ITC3,7,Liguria
2021-03-05,LOM,28987,11947,17040,20584,8403,ITC,ITC4,3,Lombardia
2021-04-23,UMB,6600,2781,3819,3481,3119,ITI,ITI2,10,Umbria
2021-02-03,LIG,2316,792,1524,55,2261,ITC,ITC3,7,Liguria
2021-02-21,EMR,4450,1708,2742,4010,440,ITH,ITH5,8,Emilia-Romagna
2021-03-26,PAB,1644,721,923,511,1133,ITH,ITH1,4,Provincia Autonoma Bolzano / Bozen
2021-01-16,PAB,2840,1265,1575,2840,0,ITH,ITH1,4,Provincia Autonoma Bolzano / Bozen
2021-02-18,BAS,1070,401,669,855,215,ITF,ITF5,17,Basilicata
2021-03-10,PIE,13629,5166,8463,11335,2294,ITC,ITC1,1,Piemonte
2021-04-27,BAS,4725,2242,2483,4400,325,ITF,ITF5,17,Basilicata
2021-01-07,CAL,2183,1063,1120,2183,0,ITF,ITF6,18,Calabria
2021-02-19,VEN,7322,3141,4181,7119,203,ITH,ITH3,5,Veneto
2021-04-04,UMB,59,20,39,23,36,ITI,ITI2,10,Umbria
2021-01-22,CAM,1524,776,748,673,851,ITF,ITF3,15,Campania
2021-02-12,CAM,6529,2861,3668,6343,186,ITF,ITF3,15,Campania
2021-02-28,EMR,6822,2527,4295,4976,1846,ITH,ITH5,8,Emilia-Romagna
2021-03-18,FVG,3371,1421,1950,1690,1681,ITH,ITH4,6,Friuli-Venezia Giulia
2021-03-26,UMB,4570,1682,2888,4398,172,ITI,ITI2,10,Umbria
2021-02-22,PUG,9627,4533,5094,9295,332,ITF,ITF4,16,Puglia
2021-01-19,MOL,173,63,110,162,11,ITF,ITF2,14,Molise
2021-03-05,FVG,3736,1478,2258,2663,1073,ITH,ITH4,6,Friuli-Venezia Giulia
2021-04-21,PIE,25680,11805,13875,20356,5324,ITC,ITC1,1,Piemonte
2021-01-06,VEN,8132,2385,5747,8132,0,ITH,ITH3,5,Veneto
2021-03-30,LAZ,25256,11584,13672,18109,7147,ITI,ITI4,12,Lazio
2021-04-28,VEN,32325,15133,17192,23296,9029,ITH,ITH3,5,Veneto
2021-02-23,CAL,1546,727,819,1431,115,ITF,ITF6,18,Calabria
2021-05-08,VDA,904,540,364,526,378,ITC,ITC2,2,Valle d'Aosta / Vallée d'Aoste
2021-03-26,EMR,23407,9897,13510,16974,6433,ITH,ITH5,8,Emilia-Romagna
2021-04-11,FVG,3433,1520,1913,2527,906,ITH,ITH4,6,Friuli-Venezia Giulia
2021-02-05,LIG,2675,986,1689,304,2371,ITC,ITC3,7,Liguria
2021-02-08,PAT,1151,318,833,342,809,ITH,ITH2,4,Provincia Autonoma Trento
2021-01-19,VDA,256,77,179,256,0,ITC,ITC2,2,Valle d'Aosta / Vallée d'Aoste
2021-02-07,PAB,2361,1057,1304,14,2347,ITH,ITH1,4,Provincia Autonoma Bolzano / Bozen
2021-04-15,TOS,24371,10183,14188,15852,8519,ITI,ITI1,9,Toscana
2021-01-08,MAR,1576,588,988,1576,0,ITI,ITI3,11,Marche
2021-01-29,LAZ,8041,3078,4963,812,7229,ITI,ITI4,12,Lazio
2021-02-24,FVG,2518,1082,1436,2500,18,ITH,ITH4,6,Friuli-Venezia Giulia
2021-05-13,VEN,43443,21444,21999,33762,9681,ITH,ITH3,5,Veneto
2020-12-27,EMR,970,372,598,970,0,ITH,ITH5,8,Emilia-Romagna
2021-01-20,MOL,18,8,10,18,0,ITF,ITF2,14,Molise
2021-02-25,LIG,3454,1349,2105,3324,130,ITC,ITC3,7,Liguria
2021-03-04,CAM,14659,5352,9307,8766,5893,ITF,ITF3,15,Campania
2021-03-31,PUG,14033,6349,7684,8479,5554,ITF,ITF4,16,Puglia
2021-04-13,VDA,373,171,202,329,44,ITC,ITC2,2,Valle d'Aosta / Vallée d'Aoste
2021-02-08,PIE,6916,2355,4561,666,6250,ITC,ITC1,1,Piemonte
2021-03-05,TOS,16491,6336,10155,11750,4741,ITI,ITI1,9,Toscana
2021-04-03,PIE,19429,8156,11273,10882,8547,ITC,ITC1,1,Piemonte
2021-02-10,LOM,14392,4504,9888,7572,6820,ITC,ITC4,3,Lombardia
2021-03-23,PAB,1552,759,793,1551,1,ITH,ITH1,4,Provincia Autonoma Bolzano / Bozen
2021-05-04,PAB,3447,1843,1604,2410,1037,ITH,ITH1,4,Provincia Autonoma Bolzano / Bozen
2021-02-05,PAT,801,271,530,283,518,ITH,ITH2,4,Provincia Autonoma Trento
2021-04-14,LOM,47107,21007,26100,34141,12966,ITC,ITC4,3,Lombardia
2021-03-12,SAR,5756,2408,3348,4448,1308,ITG,ITG2,20,Sardegna
2021-04-10,PAT,2792,1306,1486,1998,794,ITH,ITH2,4,Provincia Autonoma Trento
2021-04-14,LIG,13020,5655,7365,10817,2203,ITC,ITC3,7,Liguria
2021-04-20,EMR,22530,10363,12167,14201,8329,ITH,ITH5,8,Emilia-Romagna
2021-02-26,SIC,12212,5969,6243,10528,1684,ITG,ITG1,19,Sicilia
2021-03-18,BAS,1348,562,786,24,1324,ITF,ITF5,17,Basilicata
2021-04-23,LOM,73311,33258,40053,56809,16502,ITC,ITC4,3,Lombardia
2021-05-19,VEN,18899,8783,10116,9562,9337,ITH,ITH3,5,Veneto
2021-01-14,ABR,530,189,341,530,0,ITF,ITF1,13,Abruzzo
2021-05-17,LAZ,43682,19947,23735,35291,8391,ITI,ITI4,12,Lazio
2021-01-19,SAR,747,270,477,692,55,ITG,ITG2,20,Sardegna
2021-01-26,MAR,2016,746,1270,92,1924,ITI,ITI3,11,Marche
2021-03-16,UMB,3538,1454,2084,1911,1627,ITI,ITI2,10,Umbria
2021-04-09,UMB,6788,3160,3628,6572,216,ITI,ITI2,10,Umbria
2021-04-14,FVG,7215,3118,4097,5503,1712,ITH,ITH4,6,Friuli-Venezia Giulia
2021-04-21,ABR,6385,3101,3284,4710,1675,ITF,ITF1,13,Abruzzo
2020-12-27,LIG,135,56,79,135,0,ITC,ITC3,7,Liguria
2021-01-16,VEN,4606,1541,3065,4606,0,ITH,ITH3,5,Veneto
2021-01-28,VDA,290,123,167,56,234,ITC,ITC2,2,Valle d'Aosta / Vallée d'Aoste
2021-03-11,MOL,1463,636,827,1457,6,ITF,ITF2,14,Molise
2021-04-22,MAR,10792,4930,5862,9214,1578,ITI,ITI3,11,Marche
2020-12-31,MAR,385,180,205,385,0,ITI,ITI3,11,Marche
2021-03-22,PAT,2305,973,1332,1430,875,ITH,ITH2,4,Provincia Autonoma Trento
2021-04-27,LOM,85853,39936,45917,69350,16503,ITC,ITC4,3,Lombardia
2021-05-11,PAB,2842,1334,1508,1320,1522,ITH,ITH1,4,Provincia Autonoma Bolzano / Bozen
2021-05-17,BAS,5540,2734,2806,3410,2130,ITF,ITF5,17,Basilicata
2021-01-17,SIC,1301,589,712,1245,56,ITG,ITG1,19,Sicilia
2021-01-25,MOL,319,130,189,3,316,ITF,ITF2,14,Molise
2021-03-04,MAR,6493,2873,3620,5099,1394,ITI,ITI3,11,Marche
2021-05-18,PIE,31491,14459,17032,19169,12322,ITC,ITC1,1,Piemonte
2021-02-28,BAS,804,343,461,775,29,ITF,ITF5,17,Basilicata
2021-03-17,CAL,3794,1686,2108,2098,1696,ITF,ITF6,18,Calabria
2021-03-25,PAB,2141,1059,1082,1698,443,ITH,ITH1,4,Provincia Autonoma Bolzano / Bozen
2021-05-06,BAS,5037,2430,2607,3475,1562,ITF,ITF5,17,Basilicata
2021-05-15,CAM,62570,29000,33570,43909,18661,ITF,ITF3,15,Campania
2021-02-14,MAR,738,301,437,738,0,ITI,ITI3,11,Marche
2020-12-30,SIC,173,101,72,173,0,ITG,ITG1,19,Sicilia
2021-01-06,TOS,4520,1460,3060,4520,0,ITI,ITI1,9,Toscana
2021-01-18,CAL,1247,559,688,1041,206,ITF,ITF6,18,Calabria
2021-02-23,LOM,11773,4792,6981,11465,308,ITC,ITC4,3,Lombardia
2021-03-31,PAT,2561,983,1578,1704,857,ITH,ITH2,4,Provincia Autonoma Trento
2021-04-29,BAS,4830,2384,2446,4408,422,ITF,ITF5,17,Basilicata
2021-04-30,SIC,35154,16431,18723,23954,11200,ITG,ITG1,19,Sicilia
2021-05-10,EMR,33308,15846,17462,26101,7207,ITH,ITH5,8,Emilia-Romagna
2021-02-11,LAZ,6979,2993,3986,6467,512,ITI,ITI4,12,Lazio
2021-02-11,FVG,1930,664,1266,1738,192,ITH,ITH4,6,Friuli-Venezia Giulia
2021-02-28,LAZ,10248,4007,6241,9734,514,ITI,ITI4,12,Lazio
2021-02-07,UMB,54,17,37,1,53,ITI,ITI2,10,Umbria
2021-03-24,PAB,2040,977,1063,2027,13,ITH,ITH1,4,Provincia Autonoma Bolzano / Bozen
2021-01-13,LOM,26378,8053,18325,26378,0,ITC,ITC4,3,Lombardia
2021-02-22,PIE,8479,3471,5008,7889,590,ITC,ITC1,1,Piemonte
2020-12-29,SIC,235,146,89,235,0,ITG,ITG1,19,Sicilia
2021-03-20,VEN,12940,5340,7600,10845,2095,ITH,ITH3,5,Veneto
2021-05-16,LAZ,50674,24400,26274,37224,13450,ITI,ITI4,12,Lazio
2021-02-21,BAS,284,113,171,284,0,ITF,ITF5,17,Basilicata
2021-05-18,ABR,12121,5666,6455,7737,4384,ITF,ITF1,13,Abruzzo
2020-12-28,LIG,80,30,50,80,0,ITC,ITC3,7,Liguria
2021-01-28,CAL,2233,1109,1124,82,2151,ITF,ITF6,18,Calabria
2021-02-25,BAS,1787,736,1051,1741,46,ITF,ITF5,17,Basilicata
2021-03-06,CAL,7943,4050,3893,7188,755,ITF,ITF6,18,Calabria
2021-04-10,PUG,30663,13002,17661,26441,4222,ITF,ITF4,16,Puglia
2021-05-01,PAB,2104,1067,1037,1944,160,ITH,ITH1,4,Provincia Autonoma Bolzano / Bozen
2021-05-16,TOS,26597,12850,13747,24166,2431,ITI,ITI1,9,Toscana
2021-02-05,PUG,5634,2273,3361,1332,4302,ITF,ITF4,16,Puglia
2021-01-05,PAB,830,286,544,830,0,ITH,ITH1,4,Provincia Autonoma Bolzano / Bozen
2021-01-29,UMB,1232,348,884,79,1153,ITI,ITI2,10,Umbria
2021-02-12,MOL,330,149,181,208,122,ITF,ITF2,14,Molise
2021-02-13,VDA,216,196,20,215,1,ITC,ITC2,2,Valle d'Aosta / Vallée d'Aoste
2021-03-22,PUG,9345,4550,4795,3700,5645,ITF,ITF4,16,Puglia
2021-04-26,SIC,21922,10375,11547,13782,8140,ITG,ITG1,19,Sicilia
2021-05-19,MAR,7061,3233,3828,5094,1967,ITI,ITI3,11,Marche
2021-01-17,PAT,251,195,56,251,0,ITH,ITH2,4,Provincia Autonoma Trento
2021-04-25,VEN,18294,8139,10155,13462,4832,ITH,ITH3,5,Veneto
2021-01-21,PAB,952,442,510,139,813,ITH,ITH1,4,Provincia Autonoma Bolzano / Bozen
2021-03-29,TOS,9377,4579,4798,9053,324,ITI,ITI1,9,Toscana
2021-04-07,CAL,6358,2874,3484,3649,2709,ITF,ITF6,18,Calabria
2020-12-27,PAB,144,65,79,144,0,ITH,ITH1,4,Provincia Autonoma Bolzano / Bozen
2021-01-12,TOS,3581,1398,2183,3581,0,ITI,ITI1,9,Toscana
2021-01-27,VDA,151,71,80,79,72,ITC,ITC2,2,Valle d'Aosta / Vallée d'Aoste
2021-02-14,VDA,48,16,32,1,47,ITC,ITC2,2,Valle d'Aosta / Vallée d'Aoste
2021-03-20,FVG,3340,1351,1989,1249,2091,ITH,ITH4,6,Friuli-Venezia Giulia
2021-05-02,MOL,1860,918,942,565,1295,ITF,ITF2,14,Molise
2021-05-06,PIE,33054,15585,17469,19699,13355,ITC,ITC1,1,Piemonte
2021-02-06,PUG,4545,1927,2618,1589,2956,ITF,ITF4,16,Puglia
2021-02-24,VEN,8613,3678,4935,8128,485,ITH,ITH3,5,Veneto
2021-04-16,PUG,35694,16770,18924,32413,3281,ITF,ITF4,16,Puglia
2021-05-11,LIG,13656,6171,7485,7066,6590,ITC,ITC3,7,Liguria
2021-01-05,EMR,9347,3167,6180,9347,0,ITH,ITH5,8,Emilia-Romagna
2021-02-04,PAT,973,304,669,420,553,ITH,ITH2,4,Provincia Autonoma Trento
2021-02-07,TOS,2806,953,1853,885,1921,ITI,ITI1,9,Toscana
2021-01-01,LAZ,3554,1382,2172,3554,0,ITI,ITI4,12,Lazio
2021-03-06,SIC,12916,5167,7749,10012,2904,ITG,ITG1,19,Sicilia
2021-05-12,CAL,16200,7833,8367,10868,5332,ITF,ITF6,18,Calabria
2021-02-09,SIC,4411,1823,2588,3356,1055,ITG,ITG1,19,Sicilia
2021-02-07,SAR,1116,394,722,228,888,ITG,ITG2,20,Sardegna
2021-03-12,LAZ,22892,10125,12767,16579,6313,ITI,ITI4,12,Lazio
2021-03-22,SIC,16816,7915,8901,11273,5543,ITG,ITG1,19,Sicilia
2021-01-01,TOS,2369,787,1582,2369,0,ITI,ITI1,9,Toscana
2021-03-26,LAZ,28234,12253,15981,21391,6843,ITI,ITI4,12,Lazio
2021-04-06,VEN,28864,13268,15596,23790,5074,ITH,ITH3,5,Veneto
2021-05-14,VEN,45784,21780,24004,25367,20417,ITH,ITH3,5,Veneto
2021-01-05,TOS,5249,1755,3494,5249,0,ITI,ITI1,9,Toscana
2021-02-03,VDA,351,114,237,14,337,ITC,ITC2,2,Valle d'Aosta / Vallée d'Aoste
2021-04-04,LAZ,17464,8036,9428,12198,5266,ITI,ITI4,12,Lazio
2021-04-10,SIC,20661,10084,10577,11619,9042,ITG,ITG1,19,Sicilia
2021-05-05,PUG,38528,16842,21686,24439,14089,ITF,ITF4,16,Puglia
2021-01-26,VDA,139,48,91,0,139,ITC,ITC2,2,Valle d'Aosta / Vallée d'Aoste
2021-04-01,VEN,25033,10982,14051,18648,6385,ITH,ITH3,5,Veneto
2020-12-31,SAR,32,16,16,32,0,ITG,ITG2,20,Sardegna
2021-02-13,CAM,5508,2550,2958,5291,217,ITF,ITF3,15,Campania
2021-02-26,CAL,3061,1631,1430,2609,452,ITF,ITF6,18,Calabria
2021-03-23,LIG,9036,4082,4954,5827,3209,ITC,ITC3,7,Liguria
2021-05-06,ABR,12973,6027,6946,7965,5008,ITF,ITF1,13,Abruzzo
2021-01-12,LAZ,5392,1975,3417,5392,0,ITI,ITI4,12,Lazio
2021-01-24,LIG,756,237,519,113,643,ITC,ITC3,7,Liguria
2021-02-01,SAR,1524,605,919,225,1299,ITG,ITG2,20,Sardegna
2021-03-12,UMB,2652,1039,1613,2154,498,ITI,ITI2,10,Umbria
2021-01-04,SAR,592,217,375,592,0,ITG,ITG2,20,Sardegna
2021-01-23,LAZ,7210,2867,4343,581,6629,ITI,ITI4,12,Lazio
2021-02-17,FVG,2353,999,1354,1873,480,ITH,ITH4,6,Friuli-Venezia Giulia
2021-02-22,BAS,1790,773,1017,1737,53,ITF,ITF5,17,Basilicata
2021-03-24,CAM,17618,8082,9536,14661,2957,ITF,ITF3,15,Campania
2021-03-28,VEN,31246,13584,17662,27612,3634,ITH,ITH3,5,Veneto
2021-05-01,LIG,7134,3255,3879,1332,5802,ITC,ITC3,7,Liguria
2021-02-12,VDA,263,96,167,217,46,ITC,ITC2,2,Valle d'Aosta / Vallée d'Aoste
2021-03-02,FVG,4220,1519,2701,2721,1499,ITH,ITH4,6,Friuli-Venezia Giulia
2021-05-17,PAT,4266,2112,2154,3927,339,ITH,ITH2,4,Provincia Autonoma Trento
2021-01-24,CAM,4128,2123,2005,383,3745,ITF,ITF3,15,Campania
2021-04-16,PAT,2832,1341,1491,2687,145,ITH,ITH2,4,Provincia Autonoma Trento
2021-01-02,EMR,2353,905,1448,2353,0,ITH,ITH5,8,Emilia-Romagna
2021-05-07,MOL,2620,1219,1401,2041,579,ITF,ITF2,14,Molise
2021-01-17,PUG,1308,590,718,1239,69,ITF,ITF4,16,Puglia
2021-03-17,SIC,15162,7460,7702,9249,5913,ITG,ITG1,19,Sicilia
2021-03-25,CAM,19991,9334,10657,16488,3503,ITF,ITF3,15,Campania
2021-04-25,LOM,51316,23544,27772,46699,4617,ITC,ITC4,3,Lombardia
2021-03-08,MOL,1379,522,857,1239,140,ITF,ITF2,14,Molise
2021-04-11,MOL,1151,581,570,1138,13,ITF,ITF2,14,Molise
2021-04-29,ABR,12663,5846,6817,9565,3098,ITF,ITF1,13,Abruzzo
2021-05-09,EMR,24149,11562,12587,17198,6951,ITH,ITH5,8,Emilia-Romagna
2021-01-07,MOL,598,209,389,598,0,ITF,ITF2,14,Molise
2021-01-23,FVG,816,324,492,4,812,ITH,ITH4,6,Friuli-Venezia Giulia
2021-02-27,PUG,14194,4802,9392,12971,1223,ITF,ITF4,16,Puglia
2021-01-08,TOS,5946,1642,4304,5946,0,ITI,ITI1,9,Toscana
2021-01-20,EMR,1323,270,1053,1322,1,ITH,ITH5,8,Emilia-Romagna
2021-02-04,PUG,5897,2357,3540,1166,4731,ITF,ITF4,16,Puglia
2021-03-07,FVG,2536,926,1610,2535,1,ITH,ITH4,6,Friuli-Venezia Giulia
2021-03-19,VEN,13790,5668,8122,7697,6093,ITH,ITH3,5,Veneto
2021-05-15,VDA,1064,614,450,379,685,ITC,ITC2,2,Valle d'Aosta / Vallée d'Aoste
2021-03-25,LIG,9596,4081,5515,6203,3393,ITC,ITC3,7,Liguria
2021-04-15,MAR,10375,4673,5702,9810,565,ITI,ITI3,11,Marche
2021-01-16,LAZ,5640,2279,3361,5640,0,ITI,ITI4,12,Lazio
2021-02-21,PIE,5089,2082,3007,4987,102,ITC,ITC1,1,Piemonte
2021-02-22,SIC,8016,4149,3867,7525,491,ITG,ITG1,19,Sicilia
2021-02-05,SIC,7217,3232,3985,2132,5085,ITG,ITG1,19,Sicilia
2021-02-08,TOS,4097,1360,2737,3638,459,ITI,ITI1,9,Toscana
2021-02-13,MAR,1062,453,609,1010,52,ITI,ITI3,11,Marche
2021-03-09,VDA,206,96,110,174,32,ITC,ITC2,2,Valle d'Aosta / Vallée d'Aoste
2021-04-29,PIE,48212,21814,26398,35630,12582,ITC,ITC1,1,Piemonte
2021-05-12,LAZ,47300,21429,25871,30862,16438,ITI,ITI4,12,Lazio
2021-01-10,LOM,10518,3957,6561,10518,0,ITC,ITC4,3,Lombardia
2021-01-25,VDA,147,65,82,0,147,ITC,ITC2,2,Valle d'Aosta / Vallée d'Aoste
2021-01-30,TOS,4622,1622,3000,198,4424,ITI,ITI1,9,Toscana
2021-03-24,LIG,8945,3836,5109,5656,3289,ITC,ITC3,7,Liguria
2021-04-09,FVG,7762,3529,4233,6518,1244,ITH,ITH4,6,Friuli-Venezia Giulia
2021-01-11,MOL,557,194,363,557,0,ITF,ITF2,14,Molise
2021-04-12,VDA,485,186,299,322,163,ITC,ITC2,2,Valle d'Aosta / Vallée d'Aoste
2021-05-13,SIC,47075,22114,24961,30575,16500,ITG,ITG1,19,Sicilia
2021-02-25,ABR,3042,1330,1712,2514,528,ITF,ITF1,13,Abruzzo
2021-03-14,LOM,14876,5349,9527,11590,3286,ITC,ITC4,3,Lombardia
2021-04-26,VEN,20667,9433,11234,15518,5149,ITH,ITH3,5,Veneto
2021-02-10,ABR,947,312,635,503,444,ITF,ITF1,13,Abruzzo
2021-01-18,SAR,904,326,578,780,124,ITG,ITG2,20,Sardegna
2021-01-26,ABR,1543,567,976,30,1513,ITF,ITF1,13,Abruzzo
2021-02-08,BAS,557,193,364,151,406,ITF,ITF5,17,Basilicata
2021-02-16,FVG,2516,1135,1381,2400,116,ITH,ITH4,6,Friuli-Venezia Giulia
2021-02-28,PIE,10814,4059,6755,10574,240,ITC,ITC1,1,Piemonte
2021-03-03,LOM,26916,11495,15421,19643,7273,ITC,ITC4,3,Lombardia
2021-03-07,LIG,1857,1084,773,1556,301,ITC,ITC3,7,Liguria
2021-05-17,PUG,31208,14318,16890,19916,11292,ITF,ITF4,16,Puglia
2021-01-17,VEN,1933,781,1152,1584,349,ITH,ITH3,5,Veneto
2021-03-11,EMR,17219,7114,10105,11367,5852,ITH,ITH5,8,Emilia-Romagna
2021-03-23,CAM,15336,7055,8281,12823,2513,ITF,ITF3,15,Campania
2021-04-22,MOL,1835,858,977,1064,771,ITF,ITF2,14,Molise
2021-03-09,LOM,33234,12847,20387,25811,7423,ITC,ITC4,3,Lombardia
2021-03-24,UMB,4072,1760,2312,2749,1323,ITI,ITI2,10,Umbria
2021-05-03,ABR,11105,5239,5866,7256,3849,ITF,ITF1,13,Abruzzo
2021-01-16,MAR,2005,723,1282,2005,0,ITI,ITI3,11,Marche
2021-03-04,LIG,4738,2118,2620,3891,847,ITC,ITC3,7,Liguria
2021-04-03,PAT,1138,471,667,971,167,ITH,ITH2,4,Provincia Autonoma Trento
2021-04-12,LOM,47214,20565,26649,32884,14330,ITC,ITC4,3,Lombardia
2021-01-25,LOM,7024,2372,4652,489,6535,ITC,ITC4,3,Lombardia
2021-02-12,LOM,13946,4355,9591,9028,4918,ITC,ITC4,3,Lombardia
2021-01-02,CAM,3673,1962,1711,3673,0,ITF,ITF3,15,Campania
2021-01-30,PAB,498,245,253,4,494,ITH,ITH1,4,Provincia Autonoma Bolzano / Bozen
2021-05-15,LOM,80000,38434,41566,47227,32773,ITC,ITC4,3,Lombardia
2021-01-03,CAL,6,3,3,6,0,ITF,ITF6,18,Calabria
2021-01-07,EMR,10221,3386,6835,10221,0,ITH,ITH5,8,Emilia-Romagna
2021-01-16,PAT,319,148,171,319,0,ITH,ITH2,4,Provincia Autonoma Trento
2021-03-14,ABR,1883,731,1152,1216,667,ITF,ITF1,13,Abruzzo
2021-02-14,CAL,369,144,225,339,30,ITF,ITF6,18,Calabria
2021-02-14,LIG,233,122,111,233,0,ITC,ITC3,7,Liguria
2021-03-23,UMB,3797,1685,2112,2168,1629,ITI,ITI2,10,Umbria
2021-05-04,UMB,5526,2542,2984,2407,3119,ITI,ITI2,10,Umbria
2021-01-24,UMB,258,106,152,1,257,ITI,ITI2,10,Umbria
2021-04-25,ABR,9068,4620,4448,8259,809,ITF,ITF1,13,Abruzzo
2021-01-20,CAM,1257,650,607,1257,0,ITF,ITF3,15,Campania
2021-01-27,LOM,8045,2677,5368,821,7224,ITC,ITC4,3,Lombardia
2021-02-22,PAT,745,259,486,661,84,ITH,ITH2,4,Provincia Autonoma Trento
2021-03-28,SIC,10933,5137,5796,6922,4011,ITG,ITG1,19,Sicilia
2021-04-07,EMR,25744,11698,14046,19741,6003,ITH,ITH5,8,Emilia-Romagna
2021-05-03,VDA,839,400,439,488,351,ITC,ITC2,2,Valle d'Aosta / Vallée d'Aoste
2021-05-07,VDA,564,245,319,533,31,ITC,ITC2,2,Valle d'Aosta / Vallée d'Aoste
2021-05-09,PAB,4233,2404,1829,3080,1153,ITH,ITH1,4,Provincia Autonoma Bolzano / Bozen
2021-01-30,UMB,1590,490,1100,44,1546,ITI,ITI2,10,Umbria
2021-01-21,SAR,126,60,66,94,32,ITG,ITG2,20,Sardegna
2021-03-19,SIC,16516,8113,8403,10787,5729,ITG,ITG1,19,Sicilia
2021-04-27,LIG,14740,6678,8062,7161,7579,ITC,ITC3,7,Liguria
2021-05-17,MOL,2208,1083,1125,1727,481,ITF,ITF2,14,Molise
2021-01-09,FVG,2513,841,1672,2513,0,ITH,ITH4,6,Friuli-Venezia Giulia
2021-02-06,LOM,15255,5529,9726,1068,14187,ITC,ITC4,3,Lombardia
2021-02-18,PAT,1205,426,779,1143,62,ITH,ITH2,4,Provincia Autonoma Trento
2021-03-08,VDA,482,231,251,237,245,ITC,ITC2,2,Valle d'Aosta / Vallée d'Aoste
2021-03-25,UMB,3903,1699,2204,2839,1064,ITI,ITI2,10,Umbria
2021-05-04,LAZ,39640,18233,21407,26248,13392,ITI,ITI4,12,Lazio
2021-05-11,LAZ,47807,21919,25888,31493,16314,ITI,ITI4,12,Lazio
2021-03-29,PIE,15159,6384,8775,8546,6613,ITC,ITC1,1,Piemonte
2021-05-02,PAT,3512,1955,1557,3474,38,ITH,ITH2,4,Provincia Autonoma Trento
2021-05-19,PAT,3262,1593,1669,2571,691,ITH,ITH2,4,Provincia Autonoma Trento
2021-02-23,EMR,8214,3218,4996,7828,386,ITH,ITH5,8,Emilia-Romagna
2021-03-14,PAB,758,336,422,25,733,ITH,ITH1,4,Provincia Autonoma Bolzano / Bozen
2021-05-11,UMB,6207,2821,3386,4008,2199,ITI,ITI2,10,Umbria
2021-01-10,ABR,1139,409,730,1139,0,ITF,ITF1,13,Abruzzo
2021-01-29,TOS,6136,1698,4438,302,5834,ITI,ITI1,9,Toscana
2021-05-09,UMB,5762,2757,3005,5371,391,ITI,ITI2,10,Umbria
2021-01-27,CAM,7739,3820,3919,163,7576,ITF,ITF3,15,Campania
2021-03-09,CAM,13876,6636,7240,10095,3781,ITF,ITF3,15,Campania
2021-01-15,LAZ,6563,2700,3863,6563,0,ITI,ITI4,12,Lazio
2021-02-11,MOL,293,133,160,257,36,ITF,ITF2,14,Molise
2021-02-20,ABR,4779,1842,2937,4703,76,ITF,ITF1,13,Abruzzo
2021-03-16,FVG,3152,1287,1865,1072,2080,ITH,ITH4,6,Friuli-Venezia Giulia
2021-04-03,PUG,10485,4601,5884,6938,3547,ITF,ITF4,16,Puglia
2021-04-16,LOM,53565,23878,29687,39257,14308,ITC,ITC4,3,Lombardia
2021-04-19,CAM,30704,14814,15890,19139,11565,ITF,ITF3,15,Campania
2021-05-01,UMB,5372,2639,2733,2145,3227,ITI,ITI2,10,Umbria
2021-02-12,VEN,4312,1446,2866,3740,572,ITH,ITH3,5,Veneto
2021-03-12,MAR,4641,1972,2669,3403,1238,ITI,ITI3,11,Marche
2021-04-12,VEN,14897,6333,8564,6682,8215,ITH,ITH3,5,Veneto
2021-05-14,TOS,33014,15273,17741,20533,12481,ITI,ITI1,9,Toscana
2021-05-15,FVG,12095,5860,6235,7617,4478,ITH,ITH4,6,Friuli-Venezia Giulia
2021-01-08,CAL,2113,1016,1097,2113,0,ITF,ITF6,18,Calabria
2021-01-26,LIG,2484,803,1681,13,2471,ITC,ITC3,7,Liguria
2021-02-01,VDA,404,127,277,87,317,ITC,ITC2,2,Valle d'Aosta / Vallée d'Aoste
2021-03-09,LIG,5932,2754,3178,4503,1429,ITC,ITC3,7,Liguria
2021-01-12,PIE,10050,3406,6644,10050,0,ITC,ITC1,1,Piemonte
2021-01-24,PAB,12,10,2,0,12,ITH,ITH1,4,Provincia Autonoma Bolzano / Bozen
2021-01-25,VEN,6468,2075,4393,160,6308,ITH,ITH3,5,Veneto
2021-03-01,MOL,661,274,387,447,214,ITF,ITF2,14,Molise
2021-03-31,VDA,555,302,253,529,26,ITC,ITC2,2,Valle d'Aosta / Vallée d'Aoste
2021-04-21,PAB,3009,1467,1542,2161,848,ITH,ITH1,4,Provincia Autonoma Bolzano / Bozen
2021-01-07,VDA,275,111,164,275,0,ITC,ITC2,2,Valle d'Aosta / Vallée d'Aoste
2021-02-18,PUG,4378,1846,2532,3774,604,ITF,ITF4,16,Puglia
2021-03-27,CAL,8306,3770,4536,4450,3856,ITF,ITF6,18,Calabria
2021-04-30,VEN,49822,23411,26411,34160,15662,ITH,ITH3,5,Veneto
2021-02-04,MOL,758,295,463,77,681,ITF,ITF2,14,Molise
2021-03-15,BAS,2350,982,1368,521,1829,ITF,ITF5,17,Basilicata
2021-01-10,PIE,5214,2275,2939,5214,0,ITC,ITC1,1,Piemonte
2021-02-09,FVG,1841,554,1287,1555,286,ITH,ITH4,6,Friuli-Venezia Giulia
2021-03-18,EMR,13672,5806,7866,5673,7999,ITH,ITH5,8,Emilia-Romagna
2021-03-21,PIE,10711,4736,5975,4184,6527,ITC,ITC1,1,Piemonte
2021-05-12,MAR,10422,4684,5738,4921,5501,ITI,ITI3,11,Marche
2021-03-30,VDA,402,223,179,382,20,ITC,ITC2,2,Valle d'Aosta / Vallée d'Aoste
2021-05-05,LOM,87631,41798,45833,72525,15106,ITC,ITC4,3,Lombardia
2021-01-06,SIC,6475,3405,3070,6475,0,ITG,ITG1,19,Sicilia
2021-03-30,SAR,8630,3454,5176,6358,2272,ITG,ITG2,20,Sardegna
2021-01-27,LIG,1744,603,1141,141,1603,ITC,ITC3,7,Liguria
2021-04-15,SIC,21321,10369,10952,11764,9557,ITG,ITG1,19,Sicilia
2021-04-22,CAL,9351,4664,4687,6667,2684,ITF,ITF6,18,Calabria
2021-04-05,CAM,11636,5543,6093,9214,2422,ITF,ITF3,15,Campania
2021-04-19,LIG,12812,5617,7195,9003,3809,ITC,ITC3,7,Liguria
2021-04-20,TOS,18143,8103,10040,12587,5556,ITI,ITI1,9,Toscana
2021-02-21,LAZ,6987,3178,3809,6526,461,ITI,ITI4,12,Lazio
2021-03-26,MAR,6331,2606,3725,3523,2808,ITI,ITI3,11,Marche
2021-05-02,PUG,21136,9583,11553,13887,7249,ITF,ITF4,16,Puglia
2021-05-19,PUG,13439,6515,6924,10104,3335,ITF,ITF4,16,Puglia
2021-02-17,PAB,156,51,105,139,17,ITH,ITH1,4,Provincia Autonoma Bolzano / Bozen
2021-03-01,SIC,12963,6123,6840,11309,1654,ITG,ITG1,19,Sicilia
2021-04-01,LAZ,28402,13047,15355,21262,7140,ITI,ITI4,12,Lazio
2021-04-18,BAS,3721,1847,1874,2353,1368,ITF,ITF5,17,Basilicata
2021-05-15,LIG,7074,3140,3934,4297,2777,ITC,ITC3,7,Liguria
2021-01-26,CAL,1806,859,947,278,1528,ITF,ITF6,18,Calabria
2021-05-14,LAZ,50552,23079,27473,32491,18061,ITI,ITI4,12,Lazio
2021-03-08,MAR,6265,2745,3520,5263,1002,ITI,ITI3,11,Marche
2021-04-07,MOL,1687,847,840,1412,275,ITF,ITF2,14,Molise
2021-04-27,PIE,22539,10195,12344,17426,5113,ITC,ITC1,1,Piemonte
2021-02-28,PAT,242,121,121,242,0,ITH,ITH2,4,Provincia Autonoma Trento
2021-03-05,VEN,13283,4978,8305,9623,3660,ITH,ITH3,5,Veneto
2021-03-12,TOS,16516,6218,10298,12988,3528,ITI,ITI1,9,Toscana
2021-03-13,MOL,1189,594,595,200,989,ITF,ITF2,14,Molise
2021-05-04,SAR,9528,4382,5146,7675,1853,ITG,ITG2,20,Sardegna
2021-03-21,TOS,3231,1573,1658,1798,1433,ITI,ITI1,9,Toscana
2021-02-01,MAR,1362,479,883,98,1264,ITI,ITI3,11,Marche
2021-02-15,LAZ,8074,3587,4487,7443,631,ITI,ITI4,12,Lazio
2021-05-09,TOS,22478,9736,12742,9637,12841,ITI,ITI1,9,Toscana
2021-05-12,MOL,2819,1283,1536,2745,74,ITF,ITF2,14,Molise
2021-05-19,SIC,25432,12296,13136,14712,10720,ITG,ITG1,19,Sicilia
2021-03-14,LIG,1658,752,906,1054,604,ITC,ITC3,7,Liguria
2021-04-15,PUG,32275,15047,17228,28780,3495,ITF,ITF4,16,Puglia
2021-03-31,MOL,2193,919,1274,1374,819,ITF,ITF2,14,Molise
2021-05-02,VEN,37118,17204,19914,26787,10331,ITH,ITH3,5,Veneto
2021-01-12,SIC,4545,2235,2310,4545,0,ITG,ITG1,19,Sicilia
2021-02-23,PAB,769,324,445,763,6,ITH,ITH1,4,Provincia Autonoma Bolzano / Bozen
2021-03-29,BAS,2435,881,1554,2149,286,ITF,ITF5,17,Basilicata
2021-03-02,MOL,667,383,284,509,158,ITF,ITF2,14,Molise
2021-03-28,PAT,748,292,456,745,3,ITH,ITH2,4,Provincia Autonoma Trento
2021-04-13,MAR,9838,4259,5579,9605,233,ITI,ITI3,11,Marche
2021-05-08,CAM,56333,27094,29239,40529,15804,ITF,ITF3,15,Campania
2021-01-21,LAZ,5592,2340,3252,540,5052,ITI,ITI4,12,Lazio
2021-01-31,CAM,8067,3711,4356,23,8044,ITF,ITF3,15,Campania
2021-02-13,LOM,6416,2443,3973,4939,1477,ITC,ITC4,3,Lombardia
2021-04-23,ABR,7362,3379,3983,5066,2296,ITF,ITF1,13,Abruzzo
2021-01-21,UMB,610,202,408,341,269,ITI,ITI2,10,Umbria
2021-02-03,SAR,1119,419,700,426,693,ITG,ITG2,20,Sardegna
2021-01-30,SAR,3862,1392,2470,362,3500,ITG,ITG2,20,Sardegna
2021-03-13,FVG,2933,1119,1814,1662,1271,ITH,ITH4,6,Friuli-Venezia Giulia
2021-05-16,MAR,10897,4957,5940,6670,4227,ITI,ITI3,11,Marche
2021-05-03,MAR,10192,4602,5590,4786,5406,ITI,ITI3,11,Marche
2021-01-05,SIC,10531,5160,5371,10531,0,ITG,ITG1,19,Sicilia
2021-02-15,FVG,2452,910,1542,2202,250,ITH,ITH4,6,Friuli-Venezia Giulia
2021-03-10,PUG,14386,6237,8149,11268,3118,ITF,ITF4,16,Puglia
2021-03-26,MOL,2574,1045,1529,1932,642,ITF,ITF2,14,Molise
2021-04-06,PAT,2258,949,1309,1493,765,ITH,ITH2,4,Provincia Autonoma Trento
2021-01-28,EMR,10244,3336,6908,349,9895,ITH,ITH5,8,Emilia-Romagna
2021-04-08,MOL,1754,900,854,1553,201,ITF,ITF2,14,Molise
2020-12-31,SIC,878,470,408,878,0,ITG,ITG1,19,Sicilia
2021-01-29,MAR,1991,730,1261,167,1824,ITI,ITI3,11,Marche
2021-04-20,PAB,1559,782,777,1558,1,ITH,ITH1,4,Provincia Autonoma Bolzano / Bozen
2021-04-23,PIE,27410,12587,14823,20650,6760,ITC,ITC1,1,Piemonte
2021-05-16,VEN,28377,13997,14380,21315,7062,ITH,ITH3,5,Veneto
2021-01-08,SIC,8333,3866,4467,8333,0,ITG,ITG1,19,Sicilia
2021-03-25,FVG,5309,2261,3048,3176,2133,ITH,ITH4,6,Friuli-Venezia Giulia
2021-04-03,BAS,1807,749,1058,1472,335,ITF,ITF5,17,Basilicata
2021-02-02,LAZ,5908,2212,3696,637,5271,ITI,ITI4,12,Lazio
2021-04-14,PIE,27691,12554,15137,23171,4520,ITC,ITC1,1,Piemonte
2021-03-03,EMR,15805,5242,10563,13343,2462,ITH,ITH5,8,Emilia-Romagna
2021-04-04,MOL,253,141,112,238,15,ITF,ITF2,14,Molise
2021-04-19,PAB,1870,857,1013,1688,182,ITH,ITH1,4,Provincia Autonoma Bolzano / Bozen
2021-04-21,LIG,14235,6428,7807,8912,5323,ITC,ITC3,7,Liguria
2021-05-08,LIG,7527,3330,4197,2322,5205,ITC,ITC3,7,Liguria
2021-03-08,VEN,13546,6193,7353,9477,4069,ITH,ITH3,5,Veneto
2021-02-01,CAM,3985,1813,2172,110,3875,ITF,ITF3,15,Campania
2021-04-13,CAL,6481,3194,3287,5229,1252,ITF,ITF6,18,Calabria
2021-04-26,PAT,2646,1244,1402,2552,94,ITH,ITH2,4,Provincia Autonoma Trento
2021-02-02,BAS,367,143,224,175,192,ITF,ITF5,17,Basilicata
2020-12-27,LAZ,272,131,141,272,0,ITI,ITI4,12,Lazio
2020-12-27,UMB,86,45,41,86,0,ITI,ITI2,10,Umbria
2021-01-11,VEN,7238,2101,5137,7238,0,ITH,ITH3,5,Veneto
2021-01-15,VEN,5864,1819,4045,5864,0,ITH,ITH3,5,Veneto
2021-03-28,PUG,3524,1650,1874,1199,2325,ITF,ITF4,16,Puglia
2021-04-27,ABR,9092,4374,4718,6621,2471,ITF,ITF1,13,Abruzzo
2021-03-19,PAT,2423,915,1508,1571,852,ITH,ITH2,4,Provincia Autonoma Trento
2021-04-15,VEN,20801,8582,12219,10004,10797,ITH,ITH3,5,Veneto
2021-05-08,MAR,12268,5475,6793,5021,7247,ITI,ITI3,11,Marche
2021-04-11,VEN,20982,8866,12116,14675,6307,ITH,ITH3,5,Veneto
2021-04-17,PUG,39678,18786,20892,36113,3565,ITF,ITF4,16,Puglia
2021-05-10,PAB,3018,1300,1718,1413,1605,ITH,ITH1,4,Provincia Autonoma Bolzano / Bozen
2021-05-18,BAS,5893,2852,3041,3402,2491,ITF,ITF5,17,Basilicata
2021-01-03,SAR,90,36,54,90,0,ITG,ITG2,20,Sardegna
2021-03-15,PIE,10648,4157,6491,5029,5619,ITC,ITC1,1,Piemonte
2021-04-03,LAZ,24681,11093,13588,17982,6699,ITI,ITI4,12,Lazio
2021-05-10,UMB,5939,2769,3170,3787,2152,ITI,ITI2,10,Umbria
2021-04-06,PUG,13442,5965,7477,6821,6621,ITF,ITF4,16,Puglia
2021-04-27,PAB,2226,1013,1213,1150,1076,ITH,ITH1,4,Provincia Autonoma Bolzano / Bozen
2021-01-20,FVG,748,320,428,13,735,ITH,ITH4,6,Friuli-Venezia Giulia
2021-01-23,EMR,2447,870,1577,443,2004,ITH,ITH5,8,Emilia-Romagna
2021-01-28,CAM,8832,4121,4711,134,8698,ITF,ITF3,15,Campania
2021-01-03,BAS,900,344,556,900,0,ITF,ITF5,17,Basilicata
2021-01-12,LIG,2460,886,1574,2460,0,ITC,ITC3,7,Liguria
2021-03-07,EMR,6854,2637,4217,5337,1517,ITH,ITH5,8,Emilia-Romagna
2021-01-22,SIC,1249,632,617,243,1006,ITG,ITG1,19,Sicilia
2021-01-29,SIC,9355,4317,5038,426,8929,ITG,ITG1,19,Sicilia
2021-02-19,PAT,927,358,569,869,58,ITH,ITH2,4,Provincia Autonoma Trento
2021-03-29,LIG,10442,4511,5931,7312,3130,ITC,ITC3,7,Liguria
2021-04-23,BAS,4528,2177,2351,3528,1000,ITF,ITF5,17,Basilicata
2020-12-28,PIE,1,1,0,1,0,ITC,ITC1,1,Piemonte
2021-01-30,BAS,704,227,477,128,576,ITF,ITF5,17,Basilicata
2021-03-22,SAR,3549,1362,2187,3036,513,ITG,ITG2,20,Sardegna
2021-04-28,PAT,4230,1967,2263,4092,138,ITH,ITH2,4,Provincia Autonoma Trento
2021-05-19,LIG,10240,4501,5739,7801,2439,ITC,ITC3,7,Liguria
2021-02-12,LAZ,6844,2846,3998,6433,411,ITI,ITI4,12,Lazio
2021-04-14,MOL,1787,761,1026,1135,652,ITF,ITF2,14,Molise
2021-05-11,TOS,27883,12955,14928,12463,15420,ITI,ITI1,9,Toscana
2021-01-05,CAL,1456,680,776,1456,0,ITF,ITF6,18,Calabria
2021-01-19,CAM,1095,474,621,1092,3,ITF,ITF3,15,Campania
2021-01-13,PIE,10080,3223,6857,10080,0,ITC,ITC1,1,Piemonte
2021-01-17,UMB,54,17,37,54,0,ITI,ITI2,10,Umbria
2021-01-19,PAT,405,77,328,405,0,ITH,ITH2,4,Provincia Autonoma Trento
2021-02-05,ABR,1534,521,1013,788,746,ITF,ITF1,13,Abruzzo
2021-03-11,LOM,36201,13464,22737,26304,9897,ITC,ITC4,3,Lombardia
2021-03-24,CAL,7429,3391,4038,4254,3175,ITF,ITF6,18,Calabria
2021-05-03,PIE,26569,12134,14435,12436,14133,ITC,ITC1,1,Piemonte
2021-04-21,LAZ,32915,14945,17970,20556,12359,ITI,ITI4,12,Lazio
2021-01-18,MOL,114,48,66,114,0,ITF,ITF2,14,Molise
2021-04-14,VEN,15867,6878,8989,9240,6627,ITH,ITH3,5,Veneto
2021-02-02,LOM,19849,6584,13265,491,19358,ITC,ITC4,3,Lombardia
2021-02-08,LIG,1977,742,1235,306,1671,ITC,ITC3,7,Liguria
2021-02-11,VEN,4013,1239,2774,3385,628,ITH,ITH3,5,Veneto
2021-04-13,PIE,25902,11592,14310,22457,3445,ITC,ITC1,1,Piemonte
2021-01-25,LAZ,8111,3246,4865,771,7340,ITI,ITI4,12,Lazio
2021-03-11,CAM,17578,8669,8909,10300,7278,ITF,ITF3,15,Campania
2021-04-15,PAB,4398,2306,2092,4135,263,ITH,ITH1,4,Provincia Autonoma Bolzano / Bozen
2021-04-26,UMB,5360,2322,3038,3109,2251,ITI,ITI2,10,Umbria
2021-01-05,FVG,1678,551,1127,1678,0,ITH,ITH4,6,Friuli-Venezia Giulia
2021-01-20,LOM,5608,1373,4235,5493,115,ITC,ITC4,3,Lombardia
2021-04-30,LAZ,41084,18191,22893,27003,14081,ITI,ITI4,12,Lazio
2021-03-02,EMR,11816,3893,7923,9795,2021,ITH,ITH5,8,Emilia-Romagna
2021-04-18,VDA,522,254,268,518,4,ITC,ITC2,2,Valle d'Aosta / Vallée d'Aoste
2021-02-19,TOS,8287,2948,5339,7780,507,ITI,ITI1,9,Toscana
2021-04-20,ABR,5589,2689,2900,4179,1410,ITF,ITF1,13,Abruzzo
2021-02-19,PUG,4730,2010,2720,4339,391,ITF,ITF4,16,Puglia
2021-03-19,UMB,1743,565,1178,1087,656,ITI,ITI2,10,Umbria
2021-01-16,CAL,2394,1120,1274,2394,0,ITF,ITF6,18,Calabria
2021-01-16,FVG,1230,360,870,1230,0,ITH,ITH4,6,Friuli-Venezia Giulia
2021-03-18,SIC,15602,7783,7819,9864,5738,ITG,ITG1,19,Sicilia
2021-03-21,MAR,4505,1873,2632,1629,2876,ITI,ITI3,11,Marche
2021-03-26,CAL,7643,3624,4019,4527,3116,ITF,ITF6,18,Calabria
2021-02-03,BAS,666,300,366,32,634,ITF,ITF5,17,Basilicata
2021-01-21,MAR,897,253,644,585,312,ITI,ITI3,11,Marche
2021-02-02,CAM,5723,2804,2919,444,5279,ITF,ITF3,15,Campania
2021-02-26,LAZ,13080,5701,7379,11718,1362,ITI,ITI4,12,Lazio
2021-04-28,PUG,19465,8711,10754,14756,4709,ITF,ITF4,16,Puglia
2021-03-05,VDA,275,124,151,53,222,ITC,ITC2,2,Valle d'Aosta / Vallée d'Aoste
2021-04-28,TOS,19093,8175,10918,3827,15266,ITI,ITI1,9,Toscana
2021-05-16,SIC,33109,16123,16986,21785,11324,ITG,ITG1,19,Sicilia
2021-01-02,CAL,165,94,71,165,0,ITF,ITF6,18,Calabria
2021-01-02,LOM,199,72,127,199,0,ITC,ITC4,3,Lombardia
2021-04-12,LAZ,23669,10637,13032,16773,6896,ITI,ITI4,12,Lazio
2021-03-13,EMR,16045,6299,9746,10733,5312,ITH,ITH5,8,Emilia-Romagna
2021-03-28,PAB,569,212,357,11,558,ITH,ITH1,4,Provincia Autonoma Bolzano / Bozen
2021-03-30,PIE,16886,7030,9856,9015,7871,ITC,ITC1,1,Piemonte
2021-04-16,UMB,8090,3736,4354,6253,1837,ITI,ITI2,10,Umbria
2021-05-01,CAL,16435,7839,8596,12380,4055,ITF,ITF6,18,Calabria
2021-01-28,PAT,530,147,383,48,482,ITH,ITH2,4,Provincia Autonoma Trento
2021-01-16,VDA,236,80,156,236,0,ITC,ITC2,2,Valle d'Aosta / Vallée d'Aoste
2021-02-17,LAZ,9182,4603,4579,8308,874,ITI,ITI4,12,Lazio
2021-04-10,SAR,10386,4685,5701,8451,1935,ITG,ITG2,20,Sardegna
2021-01-24,CAL,44,18,26,39,5,ITF,ITF6,18,Calabria
2021-02-10,MOL,150,78,72,130,20,ITF,ITF2,14,Molise
2021-05-05,BAS,4331,2046,2285,3441,890,ITF,ITF5,17,Basilicata
2021-01-14,EMR,8099,2578,5521,8099,0,ITH,ITH5,8,Emilia-Romagna
2021-03-23,CAL,5203,2441,2762,3406,1797,ITF,ITF6,18,Calabria
2021-03-28,UMB,1096,442,654,1072,24,ITI,ITI2,10,Umbria
2021-03-30,CAL,5785,2488,3297,3194,2591,ITF,ITF6,18,Calabria
2021-04-16,ABR,7537,3488,4049,5619,1918,ITF,ITF1,13,Abruzzo
2021-01-30,ABR,1510,567,943,69,1441,ITF,ITF1,13,Abruzzo
2021-02-03,PAT,846,314,532,414,432,ITH,ITH2,4,Provincia Autonoma Trento
2021-04-06,VDA,741,381,360,629,112,ITC,ITC2,2,Valle d'Aosta / Vallée d'Aoste
2021-01-14,VEN,7061,1923,5138,7061,0,ITH,ITH3,5,Veneto
2021-02-15,MOL,144,70,74,141,3,ITF,ITF2,14,Molise
2021-03-24,SAR,7286,2998,4288,5927,1359,ITG,ITG2,20,Sardegna
2021-05-05,PIE,31987,14973,17014,19005,12982,ITC,ITC1,1,Piemonte
2021-05-10,LAZ,44100,20101,23999,30733,13367,ITI,ITI4,12,Lazio
2021-05-17,VDA,808,417,391,375,433,ITC,ITC2,2,Valle d'Aosta / Vallée d'Aoste
2021-01-03,PUG,2007,943,1064,2007,0,ITF,ITF4,16,Puglia
2021-02-04,VDA,294,86,208,8,286,ITC,ITC2,2,Valle d'Aosta / Vallée d'Aoste
2021-01-04,CAM,5826,2963,2863,5826,0,ITF,ITF3,15,Campania
2021-01-12,VEN,5230,1516,3714,5230,0,ITH,ITH3,5,Veneto
2021-02-14,PUG,787,348,439,663,124,ITF,ITF4,16,Puglia
2021-03-16,PAT,1391,506,885,608,783,ITH,ITH2,4,Provincia Autonoma Trento
2021-04-02,SAR,8987,3547,5440,5745,3242,ITG,ITG2,20,Sardegna
2021-04-16,SAR,14442,6489,7953,9099,5343,ITG,ITG2,20,Sardegna
2021-05-19,PAB,3362,1724,1638,1715,1647,ITH,ITH1,4,Provincia Autonoma Bolzano / Bozen
2021-01-12,PAB,1709,459,1250,1709,0,ITH,ITH1,4,Provincia Autonoma Bolzano / Bozen
2021-04-19,UMB,4997,2207,2790,2948,2049,ITI,ITI2,10,Umbria
2021-01-23,VEN,4050,1246,2804,32,4018,ITH,ITH3,5,Veneto
2021-01-24,SAR,90,34,56,5,85,ITG,ITG2,20,Sardegna
2021-03-07,VEN,4472,1755,2717,3911,561,ITH,ITH3,5,Veneto
2021-03-30,BAS,2739,1156,1583,2394,345,ITF,ITF5,17,Basilicata
2021-04-06,FVG,6275,2771,3504,5126,1149,ITH,ITH4,6,Friuli-Venezia Giulia
2021-01-10,BAS,77,24,53,77,0,ITF,ITF5,17,Basilicata
2021-01-11,LOM,16138,5352,10786,16138,0,ITC,ITC4,3,Lombardia
2021-01-30,PIE,5979,2135,3844,218,5761,ITC,ITC1,1,Piemonte
2021-02-04,FVG,2725,807,1918,36,2689,ITH,ITH4,6,Friuli-Venezia Giulia
2021-03-28,LIG,1142,511,631,391,751,ITC,ITC3,7,Liguria
2021-04-08,CAM,28263,13637,14626,22430,5833,ITF,ITF3,15,Campania
2021-04-24,VDA,722,400,322,555,167,ITC,ITC2,2,Valle d'Aosta / Vallée d'Aoste
2021-03-21,VDA,355,165,190,355,0,ITC,ITC2,2,Valle d'Aosta / Vallée d'Aoste
2021-04-18,MAR,8820,4131,4689,7899,921,ITI,ITI3,11,Marche
2021-02-05,BAS,984,443,541,64,920,ITF,ITF5,17,Basilicata
2021-04-09,PUG,21791,9358,12433,17171,4620,ITF,ITF4,16,Puglia
2021-05-14,LOM,84963,40976,43987,55290,29673,ITC,ITC4,3,Lombardia
2021-03-02,VEN,11476,4618,6858,8171,3305,ITH,ITH3,5,Veneto
2021-04-01,FVG,6315,2993,3322,5300,1015,ITH,ITH4,6,Friuli-Venezia Giulia
2021-02-25,PUG,11939,5048,6891,10779,1160,ITF,ITF4,16,Puglia
2020-12-28,CAL,6,2,4,6,0,ITF,ITF6,18,Calabria
2021-04-25,FVG,2359,989,1370,2348,11,ITH,ITH4,6,Friuli-Venezia Giulia
2021-03-19,LIG,5296,2235,3061,2149,3147,ITC,ITC3,7,Liguria
2021-02-13,SAR,1456,565,891,1454,2,ITG,ITG2,20,Sardegna
2021-05-01,PIE,28511,12986,15525,16715,11796,ITC,ITC1,1,Piemonte
2021-01-15,CAM,4980,2381,2599,4980,0,ITF,ITF3,15,Campania
2021-05-14,FVG,10461,5202,5259,8030,2431,ITH,ITH4,6,Friuli-Venezia Giulia
2021-01-01,SIC,815,437,378,815,0,ITG,ITG1,19,Sicilia
2021-03-15,CAM,12931,6088,6843,8187,4744,ITF,ITF3,15,Campania
2021-04-11,LAZ,19116,8432,10684,13235,5881,ITI,ITI4,12,Lazio
2021-04-20,FVG,7105,3059,4046,3202,3903,ITH,ITH4,6,Friuli-Venezia Giulia
2021-05-02,LOM,83457,38321,45136,61040,22417,ITC,ITC4,3,Lombardia
2021-05-19,UMB,6878,3176,3702,4415,2463,ITI,ITI2,10,Umbria
2021-01-03,PAT,492,160,332,492,0,ITH,ITH2,4,Provincia Autonoma Trento
2021-02-06,PIE,7984,2664,5320,400,7584,ITC,ITC1,1,Piemonte
2021-02-03,CAM,8902,4002,4900,878,8024,ITF,ITF3,15,Campania
2021-02-06,SAR,1970,697,1273,569,1401,ITG,ITG2,20,Sardegna
2021-02-14,PAT,246,186,60,11,235,ITH,ITH2,4,Provincia Autonoma Trento
2021-02-20,MOL,1018,441,577,998,20,ITF,ITF2,14,Molise
2021-04-14,EMR,26902,12769,14133,20835,6067,ITH,ITH5,8,Emilia-Romagna
2021-01-04,PAT,870,227,643,870,0,ITH,ITH2,4,Provincia Autonoma Trento
2021-02-22,UMB,1859,778,1081,1773,86,ITI,ITI2,10,Umbria
2021-03-16,PUG,9863,4683,5180,3507,6356,ITF,ITF4,16,Puglia
2021-05-01,SAR,9721,4674,5047,5376,4345,ITG,ITG2,20,Sardegna
2021-05-02,UMB,3787,1868,1919,1333,2454,ITI,ITI2,10,Umbria
2021-05-09,ABR,9154,4089,5065,4282,4872,ITF,ITF1,13,Abruzzo
2021-01-02,ABR,548,218,330,548,0,ITF,ITF1,13,Abruzzo
2021-02-11,EMR,4250,1416,2834,3410,840,ITH,ITH5,8,Emilia-Romagna
2021-04-01,CAL,8323,3761,4562,3838,4485,ITF,ITF6,18,Calabria
2021-05-05,ABR,11572,5541,6031,6444,5128,ITF,ITF1,13,Abruzzo
2021-01-15,LOM,25205,7429,17776,25205,0,ITC,ITC4,3,Lombardia
2021-02-28,VDA,260,86,174,77,183,ITC,ITC2,2,Valle d'Aosta / Vallée d'Aoste
2021-04-16,PIE,28306,13171,15135,23384,4922,ITC,ITC1,1,Piemonte
2021-05-18,SIC,34911,16701,18210,22722,12189,ITG,ITG1,19,Sicilia
2020-12-27,TOS,620,267,353,620,0,ITI,ITI1,9,Toscana
2021-02-01,LIG,2558,923,1635,90,2468,ITC,ITC3,7,Liguria
2021-03-17,LAZ,13790,5898,7892,7535,6255,ITI,ITI4,12,Lazio
2021-04-09,PAT,2705,1143,1562,1506,1199,ITH,ITH2,4,Provincia Autonoma Trento
2021-05-14,CAL,19830,9537,10293,13030,6800,ITF,ITF6,18,Calabria
2021-04-09,CAM,29835,13961,15874,23716,6119,ITF,ITF3,15,Campania
2021-01-06,FVG,710,264,446,710,0,ITH,ITH4,6,Friuli-Venezia Giulia
2021-01-13,BAS,916,387,529,916,0,ITF,ITF5,17,Basilicata
2021-02-06,ABR,1610,742,868,602,1008,ITF,ITF1,13,Abruzzo
2021-02-25,PAT,1640,643,997,1200,440,ITH,ITH2,4,Provincia Autonoma Trento
2021-03-06,LAZ,18272,7038,11234,14016,4256,ITI,ITI4,12,Lazio
2021-03-12,SIC,13108,5608,7500,10892,2216,ITG,ITG1,19,Sicilia
2021-04-07,VEN,35840,16085,19755,28510,7330,ITH,ITH3,5,Veneto
2021-04-09,VEN,31091,13689,17402,22755,8336,ITH,ITH3,5,Veneto
2021-01-31,VDA,291,91,200,58,233,ITC,ITC2,2,Valle d'Aosta / Vallée d'Aoste
2021-02-27,SIC,12432,5563,6869,11227,1205,ITG,ITG1,19,Sicilia
2021-04-15,LIG,11813,5217,6596,9962,1851,ITC,ITC3,7,Liguria
2021-05-04,MAR,10843,4787,6056,4949,5894,ITI,ITI3,11,Marche
2021-03-10,TOS,18011,7073,10938,13994,4017,ITI,ITI1,9,Toscana
2021-05-03,CAL,14644,6708,7936,10522,4122,ITF,ITF6,18,Calabria
2021-04-10,PIE,30158,13414,16744,25880,4278,ITC,ITC1,1,Piemonte
2021-03-03,LAZ,17392,7433,9959,13098,4294,ITI,ITI4,12,Lazio
2021-03-21,LIG,552,221,331,69,483,ITC,ITC3,7,Liguria
2021-04-29,LOM,115273,53506,61767,85544,29729,ITC,ITC4,3,Lombardia
2021-05-14,PIE,32614,15871,16743,17391,15223,ITC,ITC1,1,Piemonte
2021-01-28,FVG,2238,794,1444,354,1884,ITH,ITH4,6,Friuli-Venezia Giulia
2021-01-29,PAB,1497,510,987,24,1473,ITH,ITH1,4,Provincia Autonoma Bolzano / Bozen
2021-02-06,BAS,902,367,535,146,756,ITF,ITF5,17,Basilicata
2021-04-08,ABR,7338,3317,4021,5060,2278,ITF,ITF1,13,Abruzzo
2021-04-05,VDA,461,222,239,457,4,ITC,ITC2,2,Valle d'Aosta / Vallée d'Aoste
2021-04-16,BAS,3338,1642,1696,2421,917,ITF,ITF5,17,Basilicata
2021-05-12,SAR,10224,4591,5633,7158,3066,ITG,ITG2,20,Sardegna
2021-01-20,CAL,1397,624,773,1396,1,ITF,ITF6,18,Calabria
2021-03-11,FVG,3352,1413,1939,1603,1749,ITH,ITH4,6,Friuli-Venezia Giulia
2021-04-13,PAT,2546,1054,1492,2039,507,ITH,ITH2,4,Provincia Autonoma Trento
2021-04-19,SAR,10176,4612,5564,8759,1417,ITG,ITG2,20,Sardegna
2021-05-06,LOM,89355,42044,47311,73199,16156,ITC,ITC4,3,Lombardia
2021-02-08,SAR,1470,533,937,856,614,ITG,ITG2,20,Sardegna
2021-02-11,LOM,17043,5003,12040,9699,7344,ITC,ITC4,3,Lombardia
2021-04-14,CAM,27640,13331,14309,19075,8565,ITF,ITF3,15,Campania
2021-03-17,MAR,3428,1494,1934,107,3321,ITI,ITI3,11,Marche
2021-03-30,CAM,21728,10271,11457,18769,2959,ITF,ITF3,15,Campania
2021-03-30,PUG,11836,5485,6351,5968,5868,ITF,ITF4,16,Puglia
2021-03-06,MAR,5700,2623,3077,4433,1267,ITI,ITI3,11,Marche
2021-03-11,CAL,6877,3276,3601,5621,1256,ITF,ITF6,18,Calabria
2021-01-27,MOL,674,251,423,8,666,ITF,ITF2,14,Molise
2021-04-03,VDA,676,341,335,661,15,ITC,ITC2,2,Valle d'Aosta / Vallée d'Aoste
2021-04-30,TOS,39886,17624,22262,20059,19827,ITI,ITI1,9,Toscana
2021-03-01,LAZ,17098,7350,9748,13213,3885,ITI,ITI4,12,Lazio
2021-03-18,UMB,2942,1164,1778,1704,1238,ITI,ITI2,10,Umbria
2021-02-13,BAS,799,313,486,738,61,ITF,ITF5,17,Basilicata
2021-02-16,LAZ,8412,4090,4322,7807,605,ITI,ITI4,12,Lazio
2020-12-30,PAT,7,3,4,7,0,ITH,ITH2,4,Provincia Autonoma Trento
2021-03-18,PAB,1302,531,771,226,1076,ITH,ITH1,4,Provincia Autonoma Bolzano / Bozen
2021-03-24,BAS,1745,680,1065,1350,395,ITF,ITF5,17,Basilicata
2021-05-02,ABR,10421,5086,5335,5212,5209,ITF,ITF1,13,Abruzzo
2021-05-04,MOL,2697,1179,1518,2570,127,ITF,ITF2,14,Molise
2021-02-26,MOL,563,260,303,490,73,ITF,ITF2,14,Molise
2021-03-25,EMR,21367,9335,12032,14380,6987,ITH,ITH5,8,Emilia-Romagna
2021-04-21,TOS,29571,12649,16922,17489,12082,ITI,ITI1,9,Toscana
2021-05-03,PUG,32986,14730,18256,22385,10601,ITF,ITF4,16,Puglia
2021-03-30,PAT,2382,971,1411,1745,637,ITH,ITH2,4,Provincia Autonoma Trento
2021-05-03,PAT,4234,2178,2056,4081,153,ITH,ITH2,4,Provincia Autonoma Trento
2020-12-30,TOS,327,104,223,327,0,ITI,ITI1,9,Toscana
2021-02-11,PAB,1092,431,661,239,853,ITH,ITH1,4,Provincia Autonoma Bolzano / Bozen
2021-05-15,MOL,2975,1397,1578,2591,384,ITF,ITF2,14,Molise
2021-01-01,SAR,32,17,15,32,0,ITG,ITG2,20,Sardegna
2021-01-06,LAZ,5121,1961,3160,5121,0,ITI,ITI4,12,Lazio
2021-03-09,MOL,1329,579,750,1177,152,ITF,ITF2,14,Molise
2021-04-02,BAS,2319,1046,1273,1714,605,ITF,ITF5,17,Basilicata
2021-04-12,MOL,1261,547,714,1019,242,ITF,ITF2,14,Molise
2021-04-29,PAB,2630,1351,1279,1936,694,ITH,ITH1,4,Provincia Autonoma Bolzano / Bozen
2021-04-15,UMB,7623,3481,4142,5737,1886,ITI,ITI2,10,Umbria
2021-04-24,MAR,12025,5304,6721,7559,4466,ITI,ITI3,11,Marche
2021-05-18,SAR,12846,6238,6608,9083,3763,ITG,ITG2,20,Sardegna
2021-02-10,PAB,1635,604,1031,26,1609,ITH,ITH1,4,Provincia Autonoma Bolzano / Bozen
2021-02-27,LIG,1888,921,967,1759,129,ITC,ITC3,7,Liguria
2021-03-14,LAZ,17087,6609,10478,11933,5154,ITI,ITI4,12,Lazio
2021-02-18,VDA,349,153,196,261,88,ITC,ITC2,2,Valle d'Aosta / Vallée d'Aoste
2021-02-20,EMR,5317,2094,3223,5053,264,ITH,ITH5,8,Emilia-Romagna
2021-02-22,SAR,1639,949,690,1411,228,ITG,ITG2,20,Sardegna
2021-03-02,ABR,3963,1676,2287,3279,684,ITF,ITF1,13,Abruzzo
2021-04-13,PUG,28559,13543,15016,25164,3395,ITF,ITF4,16,Puglia
2021-05-16,PAB,2024,931,1093,1330,694,ITH,ITH1,4,Provincia Autonoma Bolzano / Bozen
2021-02-19,VDA,292,102,190,268,24,ITC,ITC2,2,Valle d'Aosta / Vallée d'Aoste
2021-05-15,VEN,35903,17357,18546,26026,9877,ITH,ITH3,5,Veneto
2021-05-16,UMB,5307,2531,2776,5255,52,ITI,ITI2,10,Umbria
2021-03-04,SAR,4002,1953,2049,2747,1255,ITG,ITG2,20,Sardegna
2021-03-22,PIE,11474,4862,6612,3868,7606,ITC,ITC1,1,Piemonte
2021-04-29,UMB,5196,2241,2955,2870,2326,ITI,ITI2,10,Umbria
2021-05-09,CAL,9611,4488,5123,6133,3478,ITF,ITF6,18,Calabria
2021-01-10,PUG,2349,1061,1288,2349,0,ITF,ITF4,16,Puglia
2021-03-27,MOL,2738,1272,1466,1305,1433,ITF,ITF2,14,Molise
2021-04-25,LAZ,24467,11196,13271,16657,7810,ITI,ITI4,12,Lazio
2021-02-10,VEN,4751,1588,3163,3697,1054,ITH,ITH3,5,Veneto
2021-02-11,UMB,842,349,493,837,5,ITI,ITI2,10,Umbria
2021-02-15,EMR,2900,849,2051,2774,126,ITH,ITH5,8,Emilia-Romagna
2021-03-04,PIE,14491,5733,8758,11542,2949,ITC,ITC1,1,Piemonte
2021-03-14,TOS,7207,2574,4633,3272,3935,ITI,ITI1,9,Toscana
2021-05-09,FVG,7323,3286,4037,3474,3849,ITH,ITH4,6,Friuli-Venezia Giulia
2021-01-24,BAS,836,300,536,58,778,ITF,ITF5,17,Basilicata
2021-05-11,SIC,32407,15411,16996,19866,12541,ITG,ITG1,19,Sicilia
2021-01-11,ABR,1551,557,994,1551,0,ITF,ITF1,13,Abruzzo
2021-01-13,CAM,8019,3665,4354,8019,0,ITF,ITF3,15,Campania
2020-12-30,PUG,1,0,1,1,0,ITF,ITF4,16,Puglia
2021-03-27,VEN,32048,13990,18058,26242,5806,ITH,ITH3,5,Veneto
2021-01-03,CAM,3837,2009,1828,3837,0,ITF,ITF3,15,Campania
2021-02-07,PUG,1578,669,909,253,1325,ITF,ITF4,16,Puglia
2021-03-24,PIE,15500,6338,9162,6375,9125,ITC,ITC1,1,Piemonte
2020-12-27,SIC,91,55,36,91,0,ITG,ITG1,19,Sicilia
2021-02-15,PAB,72,42,30,26,46,ITH,ITH1,4,Provincia Autonoma Bolzano / Bozen
2021-05-02,FVG,6776,3187,3589,3880,2896,ITH,ITH4,6,Friuli-Venezia Giulia
2021-04-08,CAL,9309,4381,4928,5675,3634,ITF,ITF6,18,Calabria
2021-05-01,CAM,46314,22652,23662,30218,16096,ITF,ITF3,15,Campania
2021-01-21,SIC,1351,659,692,500,851,ITG,ITG1,19,Sicilia
2021-02-14,TOS,8998,2569,6429,8888,110,ITI,ITI1,9,Toscana
2021-02-23,LAZ,11089,4782,6307,10328,761,ITI,ITI4,12,Lazio
2021-03-12,PAB,1664,734,930,1251,413,ITH,ITH1,4,Provincia Autonoma Bolzano / Bozen
2021-03-25,PAT,2874,1103,1771,1824,1050,ITH,ITH2,4,Provincia Autonoma Trento
2021-01-05,PUG,5104,2249,2855,5104,0,ITF,ITF4,16,Puglia
2021-05-10,MOL,2874,1278,1596,2514,360,ITF,ITF2,14,Molise
2021-03-23,PIE,13050,5444,7606,6808,6242,ITC,ITC1,1,Piemonte
2021-04-17,SIC,26164,13218,12946,19013,7151,ITG,ITG1,19,Sicilia
2021-01-11,FVG,1884,609,1275,1884,0,ITH,ITH4,6,Friuli-Venezia Giulia
2021-01-24,PIE,3153,959,2194,434,2719,ITC,ITC1,1,Piemonte
2021-01-29,LIG,3079,1064,2015,67,3012,ITC,ITC3,7,Liguria
2021-04-22,LAZ,38413,18875,19538,23886,14527,ITI,ITI4,12,Lazio
2021-05-18,PAB,3285,1716,1569,2121,1164,ITH,ITH1,4,Provincia Autonoma Bolzano / Bozen
2021-01-21,MOL,6,2,4,6,0,ITF,ITF2,14,Molise
2021-01-04,VDA,142,59,83,142,0,ITC,ITC2,2,Valle d'Aosta / Vallée d'Aoste
2021-02-13,MOL,132,80,52,132,0,ITF,ITF2,14,Molise
2021-02-22,CAL,1996,1012,984,1441,555,ITF,ITF6,18,Calabria
2021-04-10,CAL,11149,5023,6126,6339,4810,ITF,ITF6,18,Calabria
2021-04-15,SAR,11794,5516,6278,6845,4949,ITG,ITG2,20,Sardegna
2021-05-01,PUG,27262,12502,14760,16637,10625,ITF,ITF4,16,Puglia
2021-01-22,LIG,1816,604,1212,1330,486,ITC,ITC3,7,Liguria
2021-02-10,EMR,4015,1381,2634,2761,1254,ITH,ITH5,8,Emilia-Romagna
2021-02-15,VEN,4386,1821,2565,4146,240,ITH,ITH3,5,Veneto
2021-02-25,VDA,201,101,100,194,7,ITC,ITC2,2,Valle d'Aosta / Vallée d'Aoste
2021-03-22,BAS,1175,531,644,628,547,ITF,ITF5,17,Basilicata
2021-04-19,CAL,7652,3687,3965,6072,1580,ITF,ITF6,18,Calabria
2021-02-09,TOS,4488,1468,3020,3877,611,ITI,ITI1,9,Toscana
2021-03-31,LAZ,26082,12032,14050,18990,7092,ITI,ITI4,12,Lazio
2021-05-02,CAL,12414,5795,6619,10641,1773,ITF,ITF6,18,Calabria
2021-01-08,LAZ,7726,2894,4832,7726,0,ITI,ITI4,12,Lazio
2021-03-02,LOM,22823,9700,13123,19789,3034,ITC,ITC4,3,Lombardia
2021-03-13,VEN,17176,7257,9919,14042,3134,ITH,ITH3,5,Veneto
2021-03-22,CAL,4702,2201,2501,3036,1666,ITF,ITF6,18,Calabria
2021-05-12,LOM,86695,41440,45255,59605,27090,ITC,ITC4,3,Lombardia
2021-01-26,PUG,5360,2397,2963,571,4789,ITF,ITF4,16,Puglia
2021-02-20,SIC,7241,3725,3516,6999,242,ITG,ITG1,19,Sicilia
2021-03-16,TOS,4899,1881,3018,2655,2244,ITI,ITI1,9,Toscana
2021-04-20,CAL,7632,3838,3794,6016,1616,ITF,ITF6,18,Calabria
2021-04-27,LAZ,30571,13788,16783,19736,10835,ITI,ITI4,12,Lazio
2021-05-18,UMB,7648,3311,4337,3816,3832,ITI,ITI2,10,Umbria
2021-01-02,PIE,3545,1134,2411,3545,0,ITC,ITC1,1,Piemonte
2021-01-27,EMR,8359,2947,5412,464,7895,ITH,ITH5,8,Emilia-Romagna
2021-04-08,LOM,52263,21729,30534,35809,16454,ITC,ITC4,3,Lombardia
2021-02-09,LAZ,8797,3768,5029,4580,4217,ITI,ITI4,12,Lazio
2021-03-07,CAM,11912,5344,6568,8069,3843,ITF,ITF3,15,Campania
2021-03-25,PUG,10878,5282,5596,4647,6231,ITF,ITF4,16,Puglia
2021-03-27,EMR,21549,9019,12530,14654,6895,ITH,ITH5,8,Emilia-Romagna
2021-05-16,LIG,3663,1846,1817,2128,1535,ITC,ITC3,7,Liguria
2021-01-15,FVG,2021,605,1416,2021,0,ITH,ITH4,6,Friuli-Venezia Giulia
2021-03-13,LOM,27127,9756,17371,21070,6057,ITC,ITC4,3,Lombardia
2021-01-12,UMB,838,248,590,838,0,ITI,ITI2,10,Umbria
2021-01-14,LOM,26800,7782,19018,26800,0,ITC,ITC4,3,Lombardia
2021-02-02,ABR,1778,672,1106,222,1556,ITF,ITF1,13,Abruzzo
2021-03-10,SIC,13939,5952,7987,11554,2385,ITG,ITG1,19,Sicilia
2021-04-02,MOL,1405,691,714,644,761,ITF,ITF2,14,Molise
2021-04-10,BAS,1031,377,654,950,81,ITF,ITF5,17,Basilicata
2021-04-29,SAR,10721,4950,5771,6554,4167,ITG,ITG2,20,Sardegna
2021-01-01,PAB,6,5,1,6,0,ITH,ITH1,4,Provincia Autonoma Bolzano / Bozen
2021-02-20,VEN,6425,2015,4410,6354,71,ITH,ITH3,5,Veneto
2021-04-07,LOM,50487,20859,29628,34710,15777,ITC,ITC4,3,Lombardia
2021-04-27,TOS,10338,4906,5432,3859,6479,ITI,ITI1,9,Toscana
2021-03-17,TOS,11419,4586,6833,6891,4528,ITI,ITI1,9,Toscana
2021-02-17,MAR,1785,662,1123,1668,117,ITI,ITI3,11,Marche
2020-12-31,LAZ,5292,2121,3171,5292,0,ITI,ITI4,12,Lazio
2021-01-26,TOS,5393,1792,3601,220,5173,ITI,ITI1,9,Toscana
2021-05-01,PAT,4837,2463,2374,4802,35,ITH,ITH2,4,Provincia Autonoma Trento
2021-05-15,EMR,32342,14576,17766,22207,10135,ITH,ITH5,8,Emilia-Romagna
2021-03-06,TOS,7093,2837,4256,2901,4192,ITI,ITI1,9,Toscana
2021-03-09,EMR,14652,5951,8701,10697,3955,ITH,ITH5,8,Emilia-Romagna
2021-05-06,SAR,12278,5674,6604,9271,3007,ITG,ITG2,20,Sardegna
2021-01-01,UMB,274,105,169,274,0,ITI,ITI2,10,Umbria
2021-01-15,CAL,2795,1258,1537,2795,0,ITF,ITF6,18,Calabria
2021-01-23,LOM,1114,357,757,916,198,ITC,ITC4,3,Lombardia
2021-04-23,PUG,28958,13447,15511,23895,5063,ITF,ITF4,16,Puglia
2021-03-18,LIG,4982,2124,2858,2009,2973,ITC,ITC3,7,Liguria
2021-03-25,VEN,25825,10947,14878,19703,6122,ITH,ITH3,5,Veneto
2021-04-07,CAM,24757,11784,12973,20035,4722,ITF,ITF3,15,Campania
2021-05-12,PAB,3776,2048,1728,3623,153,ITH,ITH1,4,Provincia Autonoma Bolzano / Bozen
2021-01-26,PAT,542,154,388,27,515,ITH,ITH2,4,Provincia Autonoma Trento
2021-02-26,MAR,3630,1499,2131,3154,476,ITI,ITI3,11,Marche
2021-03-05,LIG,4869,2150,2719,3737,1132,ITC,ITC3,7,Liguria
2020-12-31,TOS,805,202,603,805,0,ITI,ITI1,9,Toscana
2021-05-08,SAR,12638,5818,6820,10492,2146,ITG,ITG2,20,Sardegna
