data_somministrazione,area,totale,sesso_maschile,sesso_femminile,prima_dose,seconda_dose,codice_NUTS1,codice_NUTS2,codice_regione_ISTAT,nome_area
2020-12-31,LOM,713,300,413,713,0,ITC,ITC4,3,Lombardia
2021-02-01,PIE,8642,3053,5589,578,8064,ITC,ITC1,1,Piemonte
2021-02-01,UMB,1285,342,943,48,1237,ITI,ITI2,10,Umbria
2021-03-21,MOL,1246,542,704,479,767,ITF,ITF2,14,Molise
2021-05-18,LAZ,43965,20045,23920,34693,9272,ITI,ITI4,12,Lazio
2021-01-04,PAB,508,201,307,508,0,ITH,ITH1,4,Provincia Autonoma Bolzano / Bozen
2021-03-21,PUG,2691,1225,1466,587,2104,ITF,ITF4,16,Puglia
2021-04-15,BAS,3386,1659,1727,2632,754,ITF,ITF5,17,Basilicata
2021-04-23,TOS,25656,11422,14234,9347,16309,ITI,ITI1,9,Toscana
2021-01-30,CAL,2176,1149,1027,358,1818,ITF,ITF6,18,Calabria
2021-02-23,MOL,582,223,359,363,219,ITF,ITF2,14,Molise
2021-02-28,LOM,7889,3257,4632,7673,216,ITC,ITC4,3,Lombardia
2021-05-20,PUG,31865,14150,17715,20176,11689,ITF,ITF4,16,Puglia
2021-01-27,LAZ,6114,2387,3727,997,5117,ITI,ITI4,12,Lazio
2021-02-28,MAR,2836,1251,1585,2830,6,ITI,ITI3,11,Marche
2021-01-04,TOS,5065,1894,3171,5065,0,ITI,ITI1,9,Toscana
2021-02-19,PIE,5535,2175,3360,5034,501,ITC,ITC1,1,Piemonte
2021-05-10,PUG,37175,16396,20779,19405,17770,ITF,ITF4,16,Puglia
2021-04-07,FVG,7493,3320,4173,6712,781,ITH,ITH4,6,Friuli-Venezia Giulia
2021-05-14,EMR,36215,16665,19550,26706,9509,ITH,ITH5,8,Emilia-Romagna
2021-01-25,UMB,648,323,325,5,643,ITI,ITI2,10,Umbria
2021-03-03,TOS,18193,6510,11683,14587,3606,ITI,ITI1,9,Toscana
2021-04-18,SIC,19724,9863,9861,15358,4366,ITG,ITG1,19,Sicilia
2021-05-03,PAB,1829,846,983,417,1412,ITH,ITH1,4,Provincia Autonoma Bolzano / Bozen
2021-05-13,EMR,35407,16309,19098,27661,7746,ITH,ITH5,8,Emilia-Romagna
2021-04-04,CAM,7958,4012,3946,6914,1044,ITF,ITF3,15,Campania
2021-01-17,EMR,2890,887,2003,2644,246,ITH,ITH5,8,Emilia-Romagna
2021-03-07,MOL,1131,501,630,1129,2,ITF,ITF2,14,Molise
2021-03-19,LOM,32400,12898,19502,19215,13185,ITC,ITC4,3,Lombardia
2021-04-20,SAR,10851,4937,5914,7638,3213,ITG,ITG2,20,Sardegna
2021-04-02,CAL,8023,3663,4360,4199,3824,ITF,ITF6,18,Calabria
2021-05-06,PAT,5483,2713,2770,4706,777,ITH,ITH2,4,Provincia Autonoma Trento
2021-05-13,ABR,11149,5041,6108,7187,3962,ITF,ITF1,13,Abruzzo
2021-01-24,PUG,1669,749,920,153,1516,ITF,ITF4,16,Puglia
2021-04-13,LAZ,25608,11855,13753,17905,7703,ITI,ITI4,12,Lazio
2021-05-06,CAL,13217,6252,6965,8940,4277,ITF,ITF6,18,Calabria
2021-05-15,LAZ,57024,27237,29787,40612,16412,ITI,ITI4,12,Lazio
2021-01-07,LIG,3229,1095,2134,3229,0,ITC,ITC3,7,Liguria
2021-01-14,PAT,699,203,496,699,0,ITH,ITH2,4,Provincia Autonoma Trento
2021-02-15,LOM,8915,3120,5795,8494,421,ITC,ITC4,3,Lombardia
2021-02-17,SIC,5414,3279,2135,4745,669,ITG,ITG1,19,Sicilia
2021-03-15,VEN,16598,7263,9335,11381,5217,ITH,ITH3,5,Veneto
2020-12-31,EMR,2207,777,1430,2207,0,ITH,ITH5,8,Emilia-Romagna
2021-01-12,CAM,5214,2563,2651,5214,0,ITF,ITF3,15,Campania
2021-01-12,CAL,2061,1019,1042,2061,0,ITF,ITF6,18,Calabria
2021-03-11,TOS,15494,5993,9501,12168,3326,ITI,ITI1,9,Toscana
2021-05-17,ABR,11025,5038,5987,6167,4858,ITF,ITF1,13,Abruzzo
2021-05-23,SIC,22837,11105,11732,12033,10804,ITG,ITG1,19,Sicilia
2021-01-08,LIG,2926,999,1927,2926,0,ITC,ITC3,7,Liguria
2021-01-17,ABR,187,59,128,180,7,ITF,ITF1,13,Abruzzo
2021-03-19,EMR,15573,6779,8794,7727,7846,ITH,ITH5,8,Emilia-Romagna
2021-04-02,CAM,21731,10409,11322,19410,2321,ITF,ITF3,15,Campania
2021-04-20,PUG,20978,9733,11245,17536,3442,ITF,ITF4,16,Puglia
2021-01-02,UMB,304,111,193,304,0,ITI,ITI2,10,Umbria
2021-01-24,FVG,305,119,186,1,304,ITH,ITH4,6,Friuli-Venezia Giulia
2021-02-05,PIE,9454,3080,6374,657,8797,ITC,ITC1,1,Piemonte
2021-03-17,ABR,4539,1873,2666,2800,1739,ITF,ITF1,13,Abruzzo
2021-01-30,PAT,386,132,254,152,234,ITH,ITH2,4,Provincia Autonoma Trento
2021-02-10,LAZ,8168,3389,4779,4850,3318,ITI,ITI4,12,Lazio
2021-02-19,CAM,9570,3559,6011,8920,650,ITF,ITF3,15,Campania
2021-03-09,VEN,16458,7377,9081,10141,6317,ITH,ITH3,5,Veneto
2021-04-10,CAM,28341,13485,14856,23425,4916,ITF,ITF3,15,Campania
2021-04-21,SIC,22660,10878,11782,16451,6209,ITG,ITG1,19,Sicilia
2021-02-20,PAB,1802,540,1262,1784,18,ITH,ITH1,4,Provincia Autonoma Bolzano / Bozen
2021-03-05,PAT,2242,703,1539,1676,566,ITH,ITH2,4,Provincia Autonoma Trento
2021-01-31,LAZ,4458,1853,2605,475,3983,ITI,ITI4,12,Lazio
2021-02-20,TOS,4641,1790,2851,4128,513,ITI,ITI1,9,Toscana
2021-02-28,ABR,1704,510,1194,1702,2,ITF,ITF1,13,Abruzzo
2021-04-05,PIE,14746,6233,8513,12189,2557,ITC,ITC1,1,Piemonte
2021-05-11,PAT,3678,1743,1935,2845,833,ITH,ITH2,4,Provincia Autonoma Trento
2021-05-13,VDA,1139,556,583,540,599,ITC,ITC2,2,Valle d'Aosta / Vallée d'Aoste
2021-05-14,VDA,959,442,517,291,668,ITC,ITC2,2,Valle d'Aosta / Vallée d'Aoste
2021-05-23,BAS,3212,1662,1550,947,2265,ITF,ITF5,17,Basilicata
2021-01-11,UMB,1315,346,969,1315,0,ITI,ITI2,10,Umbria
2021-03-15,PAT,1410,545,865,946,464,ITH,ITH2,4,Provincia Autonoma Trento
2021-03-09,UMB,4051,1971,2080,2759,1292,ITI,ITI2,10,Umbria
2021-04-12,UMB,7086,3076,4010,5369,1717,ITI,ITI2,10,Umbria
2021-02-18,LOM,14041,4926,9115,13013,1028,ITC,ITC4,3,Lombardia
2021-03-10,BAS,1651,814,837,812,839,ITF,ITF5,17,Basilicata
2021-03-11,PAB,1681,823,858,1143,538,ITH,ITH1,4,Provincia Autonoma Bolzano / Bozen
2021-05-12,CAM,40792,19911,20881,31658,9134,ITF,ITF3,15,Campania
2021-05-17,MAR,11854,5568,6286,7691,4163,ITI,ITI3,11,Marche
2021-05-22,LIG,6441,3166,3275,4900,1541,ITC,ITC3,7,Liguria
2021-04-12,EMR,19179,8980,10199,14748,4431,ITH,ITH5,8,Emilia-Romagna
2021-04-23,PAB,4540,2149,2391,3249,1291,ITH,ITH1,4,Provincia Autonoma Bolzano / Bozen
2021-05-12,PIE,31473,14975,16498,18797,12676,ITC,ITC1,1,Piemonte
2021-01-07,PAB,917,327,590,917,0,ITH,ITH1,4,Provincia Autonoma Bolzano / Bozen
2021-05-16,BAS,4959,2462,2497,2852,2107,ITF,ITF5,17,Basilicata
2021-01-13,MOL,474,160,314,474,0,ITF,ITF2,14,Molise
2021-03-29,VEN,31389,13631,17758,27557,3832,ITH,ITH3,5,Veneto
2021-05-10,SAR,9586,4258,5328,7057,2529,ITG,ITG2,20,Sardegna
2021-05-13,LOM,86622,41552,45070,58165,28457,ITC,ITC4,3,Lombardia
2021-01-02,VEN,5742,1765,3977,5742,0,ITH,ITH3,5,Veneto
2021-04-24,SIC,31342,14801,16541,23601,7741,ITG,ITG1,19,Sicilia
2021-01-26,BAS,793,350,443,101,692,ITF,ITF5,17,Basilicata
2021-04-25,PIE,20221,9302,10919,17719,2502,ITC,ITC1,1,Piemonte
2021-03-25,MAR,6657,2774,3883,3247,3410,ITI,ITI3,11,Marche
2021-04-26,EMR,27815,12891,14924,18525,9290,ITH,ITH5,8,Emilia-Romagna
2021-01-08,LOM,12669,3913,8756,12669,0,ITC,ITC4,3,Lombardia
2021-03-05,PUG,17213,6816,10397,15049,2164,ITF,ITF4,16,Puglia
2021-01-30,PUG,5527,2515,3012,411,5116,ITF,ITF4,16,Puglia
2021-04-29,PAT,4619,2231,2388,4410,209,ITH,ITH2,4,Provincia Autonoma Trento
2021-05-20,CAL,16893,8434,8459,11278,5615,ITF,ITF6,18,Calabria
2020-12-30,LOM,114,42,72,114,0,ITC,ITC4,3,Lombardia
2021-02-21,LOM,5052,1862,3190,5034,18,ITC,ITC4,3,Lombardia
2021-04-27,MAR,9401,4309,5092,5413,3988,ITI,ITI3,11,Marche
2021-01-19,TOS,1104,531,573,1104,0,ITI,ITI1,9,Toscana
2021-03-23,SIC,21064,10076,10988,15410,5654,ITG,ITG1,19,Sicilia
2021-03-20,VDA,208,86,122,172,36,ITC,ITC2,2,Valle d'Aosta / Vallée d'Aoste
2021-04-19,PIE,22529,10760,11769,18165,4364,ITC,ITC1,1,Piemonte
2021-04-26,ABR,8565,4067,4498,7349,1216,ITF,ITF1,13,Abruzzo
2021-02-13,LAZ,6605,2624,3981,6193,412,ITI,ITI4,12,Lazio
2021-01-31,BAS,77,24,53,0,77,ITF,ITF5,17,Basilicata
2021-03-18,TOS,9969,3980,5989,6005,3964,ITI,ITI1,9,Toscana
2021-03-28,LOM,20440,7791,12649,14276,6164,ITC,ITC4,3,Lombardia
2021-04-13,BAS,2114,1050,1064,1293,821,ITF,ITF5,17,Basilicata
2021-05-03,UMB,5085,2266,2819,2198,2887,ITI,ITI2,10,Umbria
2021-01-01,CAM,919,506,413,919,0,ITF,ITF3,15,Campania
2021-01-14,FVG,2584,789,1795,2584,0,ITH,ITH4,6,Friuli-Venezia Giulia
2021-01-23,ABR,263,114,149,57,206,ITF,ITF1,13,Abruzzo
2021-02-20,PIE,3832,1253,2579,3658,174,ITC,ITC1,1,Piemonte
2021-02-20,UMB,282,100,182,258,24,ITI,ITI2,10,Umbria
2021-03-29,SAR,4425,1559,2866,3837,588,ITG,ITG2,20,Sardegna
2021-05-10,VEN,36161,16867,19294,26458,9703,ITH,ITH3,5,Veneto
2021-03-26,CAM,19454,8927,10527,15641,3813,ITF,ITF3,15,Campania
2021-05-08,BAS,4837,2399,2438,3430,1407,ITF,ITF5,17,Basilicata
2021-04-25,TOS,11046,5247,5799,8909,2137,ITI,ITI1,9,Toscana
2021-05-16,VDA,688,341,347,347,341,ITC,ITC2,2,Valle d'Aosta / Vallée d'Aoste
2021-01-31,SIC,4108,1958,2150,113,3995,ITG,ITG1,19,Sicilia
2021-04-28,PIE,25941,11686,14255,15952,9989,ITC,ITC1,1,Piemonte
2021-02-11,CAM,6278,2704,3574,6212,66,ITF,ITF3,15,Campania
2021-02-13,TOS,7785,2360,5425,7558,227,ITI,ITI1,9,Toscana
2021-01-02,SAR,60,21,39,60,0,ITG,ITG2,20,Sardegna
2021-02-01,PAB,1451,440,1011,12,1439,ITH,ITH1,4,Provincia Autonoma Bolzano / Bozen
2021-02-19,LIG,3213,1305,1908,3037,176,ITC,ITC3,7,Liguria
2021-03-18,LAZ,14225,6078,8147,7835,6390,ITI,ITI4,12,Lazio
2021-04-06,ABR,7681,3581,4100,5362,2319,ITF,ITF1,13,Abruzzo
2021-04-09,VDA,237,111,126,204,33,ITC,ITC2,2,Valle d'Aosta / Vallée d'Aoste
2021-02-09,ABR,908,311,597,499,409,ITF,ITF1,13,Abruzzo
2021-03-22,ABR,4281,1852,2429,2311,1970,ITF,ITF1,13,Abruzzo
2021-01-21,PAT,351,94,257,228,123,ITH,ITH2,4,Provincia Autonoma Trento
2021-02-27,FVG,3518,1200,2318,3517,1,ITH,ITH4,6,Friuli-Venezia Giulia
2021-03-08,BAS,1452,708,744,841,611,ITF,ITF5,17,Basilicata
2021-02-01,TOS,5509,1958,3551,521,4988,ITI,ITI1,9,Toscana
2021-02-02,MOL,539,176,363,216,323,ITF,ITF2,14,Molise
2021-03-04,PAT,2355,791,1564,1577,778,ITH,ITH2,4,Provincia Autonoma Trento
2021-03-28,EMR,12972,5769,7203,9338,3634,ITH,ITH5,8,Emilia-Romagna
2021-05-23,LAZ,32231,14724,17507,26574,5657,ITI,ITI4,12,Lazio
2021-04-20,VEN,22392,9484,12908,8399,13993,ITH,ITH3,5,Veneto
2021-05-20,PAT,4563,2161,2402,3122,1441,ITH,ITH2,4,Provincia Autonoma Trento
2021-02-04,ABR,1680,615,1065,609,1071,ITF,ITF1,13,Abruzzo
2021-02-16,MAR,1287,475,812,1257,30,ITI,ITI3,11,Marche
2021-05-19,LOM,82259,39385,42874,33648,48611,ITC,ITC4,3,Lombardia
2021-02-10,SIC,4420,1813,2607,3999,421,ITG,ITG1,19,Sicilia
2021-02-25,LAZ,12655,5518,7137,11605,1050,ITI,ITI4,12,Lazio
2021-03-09,SAR,5645,2629,3016,4916,729,ITG,ITG2,20,Sardegna
2021-03-20,EMR,16081,6828,9253,9117,6964,ITH,ITH5,8,Emilia-Romagna
2021-02-09,LOM,12285,3344,8941,4113,8172,ITC,ITC4,3,Lombardia
2021-04-06,LOM,43009,17550,25459,25056,17953,ITC,ITC4,3,Lombardia
2021-04-28,CAM,36390,17612,18778,26644,9746,ITF,ITF3,15,Campania
2021-05-10,PAT,3205,1644,1561,2701,504,ITH,ITH2,4,Provincia Autonoma Trento
2021-02-25,TOS,10634,4305,6329,9635,999,ITI,ITI1,9,Toscana
2021-03-15,PUG,11769,5620,6149,5270,6499,ITF,ITF4,16,Puglia
2021-03-26,PIE,18081,7126,10955,8945,9136,ITC,ITC1,1,Piemonte
2021-03-27,BAS,2217,845,1372,1816,401,ITF,ITF5,17,Basilicata
2021-04-05,PAB,301,144,157,23,278,ITH,ITH1,4,Provincia Autonoma Bolzano / Bozen
2021-02-07,EMR,4793,1537,3256,1732,3061,ITH,ITH5,8,Emilia-Romagna
2021-02-24,VDA,183,82,101,164,19,ITC,ITC2,2,Valle d'Aosta / Vallée d'Aoste
2021-04-14,CAL,7945,3841,4104,6492,1453,ITF,ITF6,18,Calabria
2021-05-22,CAL,21892,10437,11455,14080,7812,ITF,ITF6,18,Calabria
2021-01-23,MAR,557,190,367,123,434,ITI,ITI3,11,Marche
2021-05-01,MOL,2631,1262,1369,410,2221,ITF,ITF2,14,Molise
2021-01-26,LAZ,7956,3125,4831,724,7232,ITI,ITI4,12,Lazio
2021-01-02,FVG,1216,470,746,1216,0,ITH,ITH4,6,Friuli-Venezia Giulia
2021-03-22,MAR,5655,2376,3279,2527,3128,ITI,ITI3,11,Marche
2021-04-06,EMR,24612,11106,13506,19875,4737,ITH,ITH5,8,Emilia-Romagna
2021-05-06,PUG,39082,17051,22031,19488,19594,ITF,ITF4,16,Puglia
2021-01-24,PAT,547,276,271,224,323,ITH,ITH2,4,Provincia Autonoma Trento
2021-04-05,TOS,15279,6823,8456,14542,737,ITI,ITI1,9,Toscana
2021-01-14,PUG,4069,1589,2480,4069,0,ITF,ITF4,16,Puglia
2021-02-10,BAS,547,237,310,495,52,ITF,ITF5,17,Basilicata
2021-02-18,LIG,2762,1126,1636,2431,331,ITC,ITC3,7,Liguria
2021-03-12,MOL,1459,637,822,1423,36,ITF,ITF2,14,Molise
2021-03-15,SAR,2685,1216,1469,2312,373,ITG,ITG2,20,Sardegna
2021-03-21,PAT,129,69,60,129,0,ITH,ITH2,4,Provincia Autonoma Trento
2021-05-11,FVG,8823,4217,4606,7035,1788,ITH,ITH4,6,Friuli-Venezia Giulia
2021-05-19,EMR,32717,14537,18180,17872,14845,ITH,ITH5,8,Emilia-Romagna
2021-01-29,VDA,318,138,180,2,316,ITC,ITC2,2,Valle d'Aosta / Vallée d'Aoste
2021-05-09,SIC,28144,13163,14981,19873,8271,ITG,ITG1,19,Sicilia
2020-12-28,SAR,65,25,40,65,0,ITG,ITG2,20,Sardegna
2021-01-03,TOS,3335,1051,2284,3335,0,ITI,ITI1,9,Toscana
2021-01-29,BAS,613,229,384,63,550,ITF,ITF5,17,Basilicata
2021-02-06,TOS,4527,1550,2977,1294,3233,ITI,ITI1,9,Toscana
2021-04-10,UMB,7465,3511,3954,7330,135,ITI,ITI2,10,Umbria
2021-02-26,SAR,2800,1108,1692,2494,306,ITG,ITG2,20,Sardegna
2021-05-19,BAS,2871,1499,1372,1196,1675,ITF,ITF5,17,Basilicata
2021-01-20,LAZ,4803,1940,2863,3260,1543,ITI,ITI4,12,Lazio
2021-02-07,BAS,373,159,214,49,324,ITF,ITF5,17,Basilicata
2021-03-04,FVG,3445,1595,1850,2787,658,ITH,ITH4,6,Friuli-Venezia Giulia
2021-02-06,PAB,2626,1171,1455,19,2607,ITH,ITH1,4,Provincia Autonoma Bolzano / Bozen
2021-03-02,LAZ,16981,7428,9553,13047,3934,ITI,ITI4,12,Lazio
2021-03-12,CAM,14246,7095,7151,8164,6082,ITF,ITF3,15,Campania
2021-05-02,TOS,11158,4922,6236,9200,1958,ITI,ITI1,9,Toscana
2021-01-13,SAR,573,178,395,573,0,ITG,ITG2,20,Sardegna
2021-03-03,PUG,16651,6694,9957,14742,1909,ITF,ITF4,16,Puglia
2021-03-29,ABR,5625,2524,3101,2986,2639,ITF,ITF1,13,Abruzzo
2021-04-17,PAB,5231,2598,2633,5187,44,ITH,ITH1,4,Provincia Autonoma Bolzano / Bozen
2021-03-28,BAS,2139,741,1398,2122,17,ITF,ITF5,17,Basilicata
2021-05-02,PAB,2457,1288,1169,1536,921,ITH,ITH1,4,Provincia Autonoma Bolzano / Bozen
2021-04-13,TOS,8488,3506,4982,6031,2457,ITI,ITI1,9,Toscana
2021-04-14,PUG,31775,15000,16775,28470,3305,ITF,ITF4,16,Puglia
2021-05-08,LAZ,45150,20598,24552,29798,15352,ITI,ITI4,12,Lazio
2021-02-15,ABR,1794,831,963,1752,42,ITF,ITF1,13,Abruzzo
2021-03-05,EMR,17659,5743,11916,14222,3437,ITH,ITH5,8,Emilia-Romagna
2021-03-21,SAR,4030,1809,2221,2590,1440,ITG,ITG2,20,Sardegna
2021-04-17,TOS,20514,9196,11318,18392,2122,ITI,ITI1,9,Toscana
2021-01-18,CAM,957,399,558,713,244,ITF,ITF3,15,Campania
2021-03-15,LOM,31568,11333,20235,23050,8518,ITC,ITC4,3,Lombardia
2021-04-27,SIC,26354,12701,13653,15577,10777,ITG,ITG1,19,Sicilia
2020-12-29,LIG,125,33,92,125,0,ITC,ITC3,7,Liguria
2021-01-02,MAR,453,139,314,453,0,ITI,ITI3,11,Marche
2021-02-23,SAR,1519,1010,509,1285,234,ITG,ITG2,20,Sardegna
2021-04-30,PAB,3337,1592,1745,1561,1776,ITH,ITH1,4,Provincia Autonoma Bolzano / Bozen
2021-05-11,VDA,645,325,320,494,151,ITC,ITC2,2,Valle d'Aosta / Vallée d'Aoste
2021-03-13,CAM,14249,6794,7455,8967,5282,ITF,ITF3,15,Campania
2021-03-26,FVG,5796,2423,3373,3785,2011,ITH,ITH4,6,Friuli-Venezia Giulia
2021-03-29,VDA,493,233,260,453,40,ITC,ITC2,2,Valle d'Aosta / Vallée d'Aoste
2021-02-19,LOM,14115,5369,8746,13435,680,ITC,ITC4,3,Lombardia
2021-02-26,TOS,10076,3833,6243,8870,1206,ITI,ITI1,9,Toscana
2021-03-20,BAS,1286,566,720,275,1011,ITF,ITF5,17,Basilicata
2021-01-10,LAZ,4039,1700,2339,4039,0,ITI,ITI4,12,Lazio
2021-01-30,EMR,10077,3519,6558,141,9936,ITH,ITH5,8,Emilia-Romagna
2021-02-22,CAM,10681,3295,7386,10418,263,ITF,ITF3,15,Campania
2021-03-24,MOL,1630,658,972,1228,402,ITF,ITF2,14,Molise
2021-04-04,CAL,1733,876,857,1233,500,ITF,ITF6,18,Calabria
2021-01-13,PUG,4541,1731,2810,4541,0,ITF,ITF4,16,Puglia
2021-02-03,PAB,1503,478,1025,5,1498,ITH,ITH1,4,Provincia Autonoma Bolzano / Bozen
2021-02-24,BAS,1803,743,1060,1734,69,ITF,ITF5,17,Basilicata
2021-05-21,MOL,1977,995,982,1667,310,ITF,ITF2,14,Molise
2021-02-23,PUG,9342,4421,4921,8867,475,ITF,ITF4,16,Puglia
2021-04-06,BAS,1266,461,805,1082,184,ITF,ITF5,17,Basilicata
2021-02-05,UMB,780,234,546,18,762,ITI,ITI2,10,Umbria
2021-02-15,MAR,967,412,555,954,13,ITI,ITI3,11,Marche
2021-04-19,FVG,6703,3129,3574,3292,3411,ITH,ITH4,6,Friuli-Venezia Giulia
2021-05-11,MAR,10623,4832,5791,5678,4945,ITI,ITI3,11,Marche
2021-01-07,FVG,2090,717,1373,2090,0,ITH,ITH4,6,Friuli-Venezia Giulia
2021-01-19,PIE,6456,2104,4352,6444,12,ITC,ITC1,1,Piemonte
2021-01-19,UMB,103,23,80,103,0,ITI,ITI2,10,Umbria
2021-02-11,LIG,1975,767,1208,1104,871,ITC,ITC3,7,Liguria
2021-03-18,VEN,12605,5134,7471,7379,5226,ITH,ITH3,5,Veneto
2021-03-29,MAR,5860,2567,3293,3435,2425,ITI,ITI3,11,Marche
2021-04-28,FVG,7243,3194,4049,3779,3464,ITH,ITH4,6,Friuli-Venezia Giulia
2021-03-08,TOS,6369,2630,3739,1550,4819,ITI,ITI1,9,Toscana
2021-03-11,SAR,6035,2725,3310,4834,1201,ITG,ITG2,20,Sardegna
2021-04-28,LIG,14448,6520,7928,6460,7988,ITC,ITC3,7,Liguria
2021-01-08,FVG,2322,747,1575,2322,0,ITH,ITH4,6,Friuli-Venezia Giulia
2021-01-11,EMR,9336,3269,6067,9336,0,ITH,ITH5,8,Emilia-Romagna
2021-01-16,CAM,3369,1675,1694,3369,0,ITF,ITF3,15,Campania
2021-03-15,VDA,362,123,239,159,203,ITC,ITC2,2,Valle d'Aosta / Vallée d'Aoste
2021-04-15,PIE,29579,13562,16017,24105,5474,ITC,ITC1,1,Piemonte
2021-01-01,LIG,144,55,89,144,0,ITC,ITC3,7,Liguria
2021-01-06,CAM,7652,3749,3903,7652,0,ITF,ITF3,15,Campania
2021-03-16,CAL,3760,1844,1916,2173,1587,ITF,ITF6,18,Calabria
2021-01-12,LOM,20139,6677,13462,20139,0,ITC,ITC4,3,Lombardia
2021-04-25,PAT,1969,938,1031,1963,6,ITH,ITH2,4,Provincia Autonoma Trento
2021-02-03,TOS,4221,1452,2769,241,3980,ITI,ITI1,9,Toscana
2021-03-16,CAM,8086,3519,4567,3772,4314,ITF,ITF3,15,Campania
2021-03-26,LIG,9122,3854,5268,5968,3154,ITC,ITC3,7,Liguria
2021-04-26,BAS,4460,2163,2297,4240,220,ITF,ITF5,17,Basilicata
2021-05-07,LAZ,48079,22546,25533,30405,17674,ITI,ITI4,12,Lazio
2021-01-22,TOS,2866,1064,1802,528,2338,ITI,ITI1,9,Toscana
2021-01-25,EMR,6437,2137,4300,199,6238,ITH,ITH5,8,Emilia-Romagna
2021-02-26,PAB,1526,551,975,1495,31,ITH,ITH1,4,Provincia Autonoma Bolzano / Bozen
2021-02-05,VEN,8370,2534,5836,1425,6945,ITH,ITH3,5,Veneto
2021-02-08,CAM,5112,2449,2663,4310,802,ITF,ITF3,15,Campania
2021-02-12,TOS,7606,2683,4923,7393,213,ITI,ITI1,9,Toscana
2021-03-23,MOL,1642,694,948,1435,207,ITF,ITF2,14,Molise
2021-03-06,PAB,3969,2079,1890,3758,211,ITH,ITH1,4,Provincia Autonoma Bolzano / Bozen
2021-03-07,PUG,4916,1941,2975,4345,571,ITF,ITF4,16,Puglia
2021-03-19,ABR,5793,2584,3209,2774,3019,ITF,ITF1,13,Abruzzo
2021-04-02,LOM,41064,16797,24267,26669,14395,ITC,ITC4,3,Lombardia
2021-05-14,ABR,10601,5076,5525,5443,5158,ITF,ITF1,13,Abruzzo
2021-01-07,SAR,3111,1077,2034,3111,0,ITG,ITG2,20,Sardegna
2021-05-09,MOL,2040,927,1113,1944,96,ITF,ITF2,14,Molise
2021-05-12,UMB,6434,3000,3434,4294,2140,ITI,ITI2,10,Umbria
2021-01-22,PAB,248,143,105,124,124,ITH,ITH1,4,Provincia Autonoma Bolzano / Bozen
2021-02-25,CAL,2783,1497,1286,2205,578,ITF,ITF6,18,Calabria
2021-03-08,LAZ,20060,8311,11749,14787,5273,ITI,ITI4,12,Lazio
2021-04-03,CAM,21111,10314,10797,18733,2378,ITF,ITF3,15,Campania
2021-04-19,PUG,27480,12752,14728,24448,3032,ITF,ITF4,16,Puglia
2021-04-22,TOS,35698,15289,20409,18267,17431,ITI,ITI1,9,Toscana
2021-05-07,TOS,32004,14648,17356,11967,20037,ITI,ITI1,9,Toscana
2021-01-16,PIE,7771,2630,5141,7771,0,ITC,ITC1,1,Piemonte
2021-02-13,PIE,4152,1334,2818,2931,1221,ITC,ITC1,1,Piemonte
2021-03-09,MAR,5429,2293,3136,4549,880,ITI,ITI3,11,Marche
2021-04-23,SAR,12828,5727,7101,7373,5455,ITG,ITG2,20,Sardegna
2021-05-06,MAR,12656,5820,6836,5583,7073,ITI,ITI3,11,Marche
2021-01-18,PIE,6164,2047,4117,5916,248,ITC,ITC1,1,Piemonte
2021-03-16,LOM,25475,10112,15363,16419,9056,ITC,ITC4,3,Lombardia
2021-04-05,PAT,34,17,17,33,1,ITH,ITH2,4,Provincia Autonoma Trento
2021-01-21,ABR,157,47,110,157,0,ITF,ITF1,13,Abruzzo
2021-03-13,LIG,3826,1616,2210,2971,855,ITC,ITC3,7,Liguria
2021-02-07,ABR,777,307,470,201,576,ITF,ITF1,13,Abruzzo
2021-01-07,UMB,1300,387,913,1300,0,ITI,ITI2,10,Umbria
2021-02-26,UMB,660,253,407,652,8,ITI,ITI2,10,Umbria
2021-04-01,PIE,19328,8072,11256,11209,8119,ITC,ITC1,1,Piemonte
2021-05-22,EMR,31014,13358,17656,15543,15471,ITH,ITH5,8,Emilia-Romagna
2021-01-13,VEN,5985,1606,4379,5985,0,ITH,ITH3,5,Veneto
2021-03-13,PAB,2885,1459,1426,2784,101,ITH,ITH1,4,Provincia Autonoma Bolzano / Bozen
2021-04-16,PAB,2949,1418,1531,2438,511,ITH,ITH1,4,Provincia Autonoma Bolzano / Bozen
2021-02-21,VDA,18,3,15,0,18,ITC,ITC2,2,Valle d'Aosta / Vallée d'Aoste
2021-03-21,VEN,11983,4754,7229,8521,3462,ITH,ITH3,5,Veneto
2021-04-29,MAR,13246,6061,7185,7149,6097,ITI,ITI3,11,Marche
2020-12-27,MOL,50,20,30,50,0,ITF,ITF2,14,Molise
2021-01-01,LOM,24,7,17,24,0,ITC,ITC4,3,Lombardia
2021-04-16,TOS,28913,12872,16041,22021,6892,ITI,ITI1,9,Toscana
2021-04-25,PUG,11120,5155,5965,9964,1156,ITF,ITF4,16,Puglia
2021-01-09,VDA,443,199,244,443,0,ITC,ITC2,2,Valle d'Aosta / Vallée d'Aoste
2021-01-21,EMR,2156,727,1429,811,1345,ITH,ITH5,8,Emilia-Romagna
2021-03-12,LIG,6150,2814,3336,3681,2469,ITC,ITC3,7,Liguria
2021-04-20,LOM,67611,30813,36798,57282,10329,ITC,ITC4,3,Lombardia
2021-01-21,VDA,33,12,21,33,0,ITC,ITC2,2,Valle d'Aosta / Vallée d'Aoste
2021-02-03,UMB,725,174,551,67,658,ITI,ITI2,10,Umbria
2021-02-03,PIE,10197,3303,6894,611,9586,ITC,ITC1,1,Piemonte
2021-03-28,ABR,2415,1017,1398,2044,371,ITF,ITF1,13,Abruzzo
2021-04-23,VEN,31095,13781,17314,22399,8696,ITH,ITH3,5,Veneto
2021-05-13,BAS,5979,2964,3015,3383,2596,ITF,ITF5,17,Basilicata
2021-03-07,CAL,3132,1562,1570,3043,89,ITF,ITF6,18,Calabria
2021-03-07,PAT,22,6,16,22,0,ITH,ITH2,4,Provincia Autonoma Trento
2021-04-08,LAZ,26642,12169,14473,18962,7680,ITI,ITI4,12,Lazio
2021-05-12,FVG,10581,4895,5686,9228,1353,ITH,ITH4,6,Friuli-Venezia Giulia
2021-02-05,PAB,3195,1181,2014,8,3187,ITH,ITH1,4,Provincia Autonoma Bolzano / Bozen
2021-02-12,PIE,6890,2214,4676,3930,2960,ITC,ITC1,1,Piemonte
2021-02-16,VDA,325,53,272,320,5,ITC,ITC2,2,Valle d'Aosta / Vallée d'Aoste
2021-03-03,PAT,1656,622,1034,1139,517,ITH,ITH2,4,Provincia Autonoma Trento
2021-03-11,VEN,19696,8766,10930,14112,5584,ITH,ITH3,5,Veneto
2021-01-07,VEN,8358,2318,6040,8358,0,ITH,ITH3,5,Veneto
2021-02-21,MAR,376,141,235,375,1,ITI,ITI3,11,Marche
2021-04-11,EMR,15221,6907,8314,12190,3031,ITH,ITH5,8,Emilia-Romagna
2021-04-21,MOL,1860,787,1073,965,895,ITF,ITF2,14,Molise
2021-05-19,ABR,10693,5109,5584,7655,3038,ITF,ITF1,13,Abruzzo
2021-02-26,VEN,8288,3267,5021,7036,1252,ITH,ITH3,5,Veneto
2021-05-12,LIG,11934,5352,6582,6594,5340,ITC,ITC3,7,Liguria
2021-01-04,PIE,5563,1679,3884,5563,0,ITC,ITC1,1,Piemonte
2021-05-08,SIC,35742,17072,18670,25429,10313,ITG,ITG1,19,Sicilia
2021-05-10,LOM,85157,40843,44314,63668,21489,ITC,ITC4,3,Lombardia
2021-05-20,EMR,38770,17627,21143,17944,20826,ITH,ITH5,8,Emilia-Romagna
2021-01-04,UMB,810,398,412,810,0,ITI,ITI2,10,Umbria
2021-01-19,PAB,853,371,482,723,130,ITH,ITH1,4,Provincia Autonoma Bolzano / Bozen
2021-03-25,VDA,389,154,235,379,10,ITC,ITC2,2,Valle d'Aosta / Vallée d'Aoste
2021-04-19,PAT,2621,1235,1386,2598,23,ITH,ITH2,4,Provincia Autonoma Trento
2021-01-13,PAT,421,123,298,421,0,ITH,ITH2,4,Provincia Autonoma Trento
2021-01-21,LOM,5342,1569,3773,4653,689,ITC,ITC4,3,Lombardia
2021-02-11,CAL,2332,1042,1290,1081,1251,ITF,ITF6,18,Calabria
2021-02-18,FVG,3217,1492,1725,2811,406,ITH,ITH4,6,Friuli-Venezia Giulia
2021-03-18,SAR,7253,3069,4184,5650,1603,ITG,ITG2,20,Sardegna
2021-05-15,CAL,26636,12737,13899,19878,6758,ITF,ITF6,18,Calabria
2021-02-19,FVG,3251,1289,1962,2824,427,ITH,ITH4,6,Friuli-Venezia Giulia
2021-03-11,UMB,3565,1697,1868,2559,1006,ITI,ITI2,10,Umbria
2021-05-14,BAS,5898,2793,3105,3367,2531,ITF,ITF5,17,Basilicata
2021-01-17,BAS,328,133,195,327,1,ITF,ITF5,17,Basilicata
2021-01-18,LIG,2135,745,1390,1978,157,ITC,ITC3,7,Liguria
2021-02-05,SAR,1897,749,1148,433,1464,ITG,ITG2,20,Sardegna
2021-02-06,UMB,396,138,258,34,362,ITI,ITI2,10,Umbria
2021-04-01,CAM,24339,11688,12651,20207,4132,ITF,ITF3,15,Campania
2021-01-10,SIC,3621,1616,2005,3621,0,ITG,ITG1,19,Sicilia
2021-04-10,LIG,7877,3556,4321,6963,914,ITC,ITC3,7,Liguria
2021-01-16,LIG,1278,557,721,1278,0,ITC,ITC3,7,Liguria
2021-04-14,PAT,3112,1463,1649,2376,736,ITH,ITH2,4,Provincia Autonoma Trento
2021-02-07,VDA,292,120,172,190,102,ITC,ITC2,2,Valle d'Aosta / Vallée d'Aoste
2021-02-22,LIG,3334,1467,1867,3192,142,ITC,ITC3,7,Liguria
2021-02-23,VEN,7372,3247,4125,7106,266,ITH,ITH3,5,Veneto
2021-04-10,PAB,5390,2664,2726,4802,588,ITH,ITH1,4,Provincia Autonoma Bolzano / Bozen
2021-03-19,BAS,2289,992,1297,261,2028,ITF,ITF5,17,Basilicata
2021-04-18,MOL,611,264,347,104,507,ITF,ITF2,14,Molise
2021-02-21,ABR,1218,550,668,1217,1,ITF,ITF1,13,Abruzzo
2021-02-23,PAT,1108,395,713,897,211,ITH,ITH2,4,Provincia Autonoma Trento
2021-03-16,LIG,6073,2722,3351,2349,3724,ITC,ITC3,7,Liguria
2021-04-02,LIG,11671,5117,6554,9185,2486,ITC,ITC3,7,Liguria
2021-04-28,LOM,95544,43591,51953,68695,26849,ITC,ITC4,3,Lombardia
2021-04-04,LIG,756,366,390,507,249,ITC,ITC3,7,Liguria
2021-01-03,PIE,3063,967,2096,3063,0,ITC,ITC1,1,Piemonte
2021-03-14,SIC,8777,3928,4849,4943,3834,ITG,ITG1,19,Sicilia
2021-02-17,SAR,1407,577,830,1333,74,ITG,ITG2,20,Sardegna
2021-02-24,PUG,10034,4702,5332,9445,589,ITF,ITF4,16,Puglia
2021-03-06,SAR,2639,1079,1560,858,1781,ITG,ITG2,20,Sardegna
2021-03-06,EMR,20597,5878,14719,17869,2728,ITH,ITH5,8,Emilia-Romagna
2021-04-15,CAM,34335,16657,17678,24438,9897,ITF,ITF3,15,Campania
2020-12-27,CAL,281,156,125,281,0,ITF,ITF6,18,Calabria
2021-01-06,UMB,846,325,521,846,0,ITI,ITI2,10,Umbria
2021-01-22,SAR,83,47,36,55,28,ITG,ITG2,20,Sardegna
2021-01-29,CAM,10052,4812,5240,47,10005,ITF,ITF3,15,Campania
2021-01-29,PUG,6193,2660,3533,436,5757,ITF,ITF4,16,Puglia
2021-01-22,ABR,118,57,61,118,0,ITF,ITF1,13,Abruzzo
2021-03-05,ABR,5334,1953,3381,4636,698,ITF,ITF1,13,Abruzzo
2021-03-18,PAT,2317,957,1360,1238,1079,ITH,ITH2,4,Provincia Autonoma Trento
2021-03-31,SAR,10148,4047,6101,7701,2447,ITG,ITG2,20,Sardegna
2021-05-07,LOM,91923,43547,48376,69842,22081,ITC,ITC4,3,Lombardia
2021-05-20,BAS,5852,2965,2887,2890,2962,ITF,ITF5,17,Basilicata
2021-01-05,LIG,2879,896,1983,2879,0,ITC,ITC3,7,Liguria
2021-03-30,TOS,16856,7493,9363,13292,3564,ITI,ITI1,9,Toscana
2021-05-23,PAT,1475,736,739,289,1186,ITH,ITH2,4,Provincia Autonoma Trento
2021-01-21,BAS,30,10,20,30,0,ITF,ITF5,17,Basilicata
2021-03-02,TOS,10600,3799,6801,7156,3444,ITI,ITI1,9,Toscana
2021-03-08,LOM,29749,11178,18571,22680,7069,ITC,ITC4,3,Lombardia
2021-03-16,EMR,12239,5025,7214,4932,7307,ITH,ITH5,8,Emilia-Romagna
2021-03-27,PAT,1615,709,906,1363,252,ITH,ITH2,4,Provincia Autonoma Trento
2021-04-17,EMR,26964,12898,14066,17694,9270,ITH,ITH5,8,Emilia-Romagna
2021-05-04,PIE,28387,13035,15352,16337,12050,ITC,ITC1,1,Piemonte
2021-04-01,MAR,7578,3183,4395,4162,3416,ITI,ITI3,11,Marche
2021-04-17,SAR,10062,4492,5570,5465,4597,ITG,ITG2,20,Sardegna
2021-01-22,EMR,1828,477,1351,1088,740,ITH,ITH5,8,Emilia-Romagna
2021-02-03,MAR,2124,741,1383,119,2005,ITI,ITI3,11,Marche
2021-04-26,PUG,26000,11901,14099,22762,3238,ITF,ITF4,16,Puglia
2021-01-10,MOL,270,72,198,270,0,ITF,ITF2,14,Molise
2021-02-08,FVG,2357,694,1663,92,2265,ITH,ITH4,6,Friuli-Venezia Giulia
2021-02-09,MOL,359,170,189,197,162,ITF,ITF2,14,Molise
2021-04-01,LIG,12379,5468,6911,9609,2770,ITC,ITC3,7,Liguria
2021-04-22,PAB,2923,1500,1423,1981,942,ITH,ITH1,4,Provincia Autonoma Bolzano / Bozen
2021-05-16,PIE,28093,12755,15338,15049,13044,ITC,ITC1,1,Piemonte
2021-05-07,EMR,34476,16576,17900,22691,11785,ITH,ITH5,8,Emilia-Romagna
2021-01-31,MOL,268,70,198,6,262,ITF,ITF2,14,Molise
2021-02-13,PAT,536,333,203,171,365,ITH,ITH2,4,Provincia Autonoma Trento
2021-05-13,CAL,15838,7585,8253,11211,4627,ITF,ITF6,18,Calabria
2021-02-26,ABR,3915,1670,2245,2947,968,ITF,ITF1,13,Abruzzo
2021-03-03,SAR,3858,2072,1786,2610,1248,ITG,ITG2,20,Sardegna
2021-02-12,PUG,4101,1629,2472,3010,1091,ITF,ITF4,16,Puglia
2021-02-16,SAR,700,289,411,673,27,ITG,ITG2,20,Sardegna
2021-03-01,PAB,922,221,701,921,1,ITH,ITH1,4,Provincia Autonoma Bolzano / Bozen
2021-04-06,MOL,1493,700,793,1150,343,ITF,ITF2,14,Molise
2021-04-30,ABR,12391,5803,6588,6710,5681,ITF,ITF1,13,Abruzzo
2021-01-15,MAR,1771,500,1271,1771,0,ITI,ITI3,11,Marche
2021-01-22,LOM,3105,866,2239,3035,70,ITC,ITC4,3,Lombardia
2021-01-30,VDA,439,202,237,14,425,ITC,ITC2,2,Valle d'Aosta / Vallée d'Aoste
2021-02-27,PIE,12688,4849,7839,12343,345,ITC,ITC1,1,Piemonte
2021-05-07,SAR,13932,6371,7561,9608,4324,ITG,ITG2,20,Sardegna
2021-05-16,PUG,24094,10868,13226,12499,11595,ITF,ITF4,16,Puglia
2021-05-18,PUG,27925,12815,15110,15470,12455,ITF,ITF4,16,Puglia
2021-01-12,ABR,1804,666,1138,1804,0,ITF,ITF1,13,Abruzzo
2021-02-16,PAB,530,205,325,530,0,ITH,ITH1,4,Provincia Autonoma Bolzano / Bozen
2021-03-14,UMB,66,48,18,66,0,ITI,ITI2,10,Umbria
2021-03-15,SIC,10812,4712,6100,5746,5066,ITG,ITG1,19,Sicilia
2021-05-04,CAM,48427,23331,25096,39540,8887,ITF,ITF3,15,Campania
2021-01-08,MOL,429,141,288,429,0,ITF,ITF2,14,Molise
2021-04-11,BAS,848,330,518,786,62,ITF,ITF5,17,Basilicata
2021-04-22,EMR,28970,13407,15563,14937,14033,ITH,ITH5,8,Emilia-Romagna
2021-03-01,VEN,9387,3710,5677,7566,1821,ITH,ITH3,5,Veneto
2021-03-20,PIE,11916,4898,7018,6019,5897,ITC,ITC1,1,Piemonte
2021-04-22,SAR,10430,4617,5813,5513,4917,ITG,ITG2,20,Sardegna
2021-05-05,LAZ,46636,21400,25236,30887,15749,ITI,ITI4,12,Lazio
2021-01-03,MAR,896,348,548,896,0,ITI,ITI3,11,Marche
2021-01-04,MAR,1503,565,938,1503,0,ITI,ITI3,11,Marche
2021-02-12,ABR,1228,567,661,1039,189,ITF,ITF1,13,Abruzzo
2021-05-15,PUG,42357,18538,23819,23196,19161,ITF,ITF4,16,Puglia
2021-01-24,TOS,3349,1073,2276,201,3148,ITI,ITI1,9,Toscana
2021-04-17,LOM,48257,21212,27045,37488,10769,ITC,ITC4,3,Lombardia
2021-03-10,UMB,4012,1927,2085,2756,1256,ITI,ITI2,10,Umbria
2021-03-12,LOM,35238,12948,22290,25033,10205,ITC,ITC4,3,Lombardia
2021-03-18,CAL,4241,1977,2264,2273,1968,ITF,ITF6,18,Calabria
2021-04-04,EMR,9884,4718,5166,7615,2269,ITH,ITH5,8,Emilia-Romagna
2021-01-09,SAR,4026,1417,2609,4026,0,ITG,ITG2,20,Sardegna
2021-02-08,LOM,10079,2918,7161,2139,7940,ITC,ITC4,3,Lombardia
2021-01-15,LIG,2257,754,1503,2257,0,ITC,ITC3,7,Liguria
2021-04-12,CAM,23301,10917,12384,20264,3037,ITF,ITF3,15,Campania
2021-01-29,SAR,2952,1067,1885,48,2904,ITG,ITG2,20,Sardegna
2021-03-09,PIE,13962,5428,8534,11620,2342,ITC,ITC1,1,Piemonte
2021-04-22,LOM,73754,33321,40433,57463,16291,ITC,ITC4,3,Lombardia
2021-05-16,CAM,51079,23175,27904,33549,17530,ITF,ITF3,15,Campania
2020-12-27,CAM,720,422,298,720,0,ITF,ITF3,15,Campania
2021-02-21,MOL,573,227,346,571,2,ITF,ITF2,14,Molise
2021-03-15,MAR,4402,2027,2375,1312,3090,ITI,ITI3,11,Marche
2021-04-20,LAZ,30971,14214,16757,19696,11275,ITI,ITI4,12,Lazio
2021-01-28,SIC,9309,4390,4919,404,8905,ITG,ITG1,19,Sicilia
2021-02-20,FVG,2068,933,1135,1924,144,ITH,ITH4,6,Friuli-Venezia Giulia
2021-03-14,MOL,595,239,356,17,578,ITF,ITF2,14,Molise
2021-03-19,CAL,4181,1943,2238,1900,2281,ITF,ITF6,18,Calabria
2021-03-20,PUG,8250,3731,4519,3664,4586,ITF,ITF4,16,Puglia
2021-01-29,PIE,5943,1886,4057,455,5488,ITC,ITC1,1,Piemonte
2021-02-08,CAL,1847,733,1114,661,1186,ITF,ITF6,18,Calabria
2021-02-17,PIE,4792,2155,2637,3803,989,ITC,ITC1,1,Piemonte
2021-04-27,SAR,7601,3544,4057,5562,2039,ITG,ITG2,20,Sardegna
2021-01-14,VDA,237,69,168,237,0,ITC,ITC2,2,Valle d'Aosta / Vallée d'Aoste
2021-03-06,ABR,4176,1357,2819,3606,570,ITF,ITF1,13,Abruzzo
2021-03-16,SIC,9784,4365,5419,3666,6118,ITG,ITG1,19,Sicilia
2021-04-18,CAM,27213,13281,13932,18315,8898,ITF,ITF3,15,Campania
2021-01-24,LAZ,5694,2229,3465,612,5082,ITI,ITI4,12,Lazio
2021-03-08,CAL,5460,2868,2592,4362,1098,ITF,ITF6,18,Calabria
2021-03-25,TOS,23613,10124,13489,15275,8338,ITI,ITI1,9,Toscana
2021-01-27,PUG,4578,1928,2650,611,3967,ITF,ITF4,16,Puglia
2021-05-06,VDA,1063,509,554,679,384,ITC,ITC2,2,Valle d'Aosta / Vallée d'Aoste
2021-02-16,VEN,6638,2870,3768,6461,177,ITH,ITH3,5,Veneto
2021-02-22,VDA,316,94,222,213,103,ITC,ITC2,2,Valle d'Aosta / Vallée d'Aoste
2021-02-24,CAL,1844,940,904,1369,475,ITF,ITF6,18,Calabria
2021-04-24,MOL,2080,975,1105,607,1473,ITF,ITF2,14,Molise
2021-01-22,VEN,1080,332,748,25,1055,ITH,ITH3,5,Veneto
2021-01-28,LAZ,8278,3164,5114,781,7497,ITI,ITI4,12,Lazio
2021-03-21,BAS,1046,481,565,352,694,ITF,ITF5,17,Basilicata
2021-04-27,UMB,5648,2398,3250,3078,2570,ITI,ITI2,10,Umbria
2021-01-29,CAL,2043,984,1059,230,1813,ITF,ITF6,18,Calabria
2021-03-31,VEN,38516,16190,22326,31025,7491,ITH,ITH3,5,Veneto
2021-01-24,MAR,880,339,541,5,875,ITI,ITI3,11,Marche
2021-02-12,PAT,1010,340,670,589,421,ITH,ITH2,4,Provincia Autonoma Trento
2021-02-17,VEN,6022,2772,3250,5928,94,ITH,ITH3,5,Veneto
2021-03-12,FVG,3938,1544,2394,2557,1381,ITH,ITH4,6,Friuli-Venezia Giulia
2021-04-18,EMR,17442,8370,9072,12533,4909,ITH,ITH5,8,Emilia-Romagna
2021-05-20,ABR,12545,5783,6762,7332,5213,ITF,ITF1,13,Abruzzo
2021-01-22,CAL,658,274,384,656,2,ITF,ITF6,18,Calabria
2021-03-05,BAS,1854,857,997,1108,746,ITF,ITF5,17,Basilicata
2021-03-08,PIE,14171,5403,8768,11458,2713,ITC,ITC1,1,Piemonte
2021-03-10,LOM,33226,12725,20501,25371,7855,ITC,ITC4,3,Lombardia
2021-05-21,CAL,21277,10831,10446,13949,7328,ITF,ITF6,18,Calabria
2021-03-06,UMB,4267,1110,3157,4124,143,ITI,ITI2,10,Umbria
2021-03-31,CAL,8818,4006,4812,4882,3936,ITF,ITF6,18,Calabria
2021-04-07,LAZ,24955,11318,13637,17653,7302,ITI,ITI4,12,Lazio
2021-01-27,FVG,1272,425,847,450,822,ITH,ITH4,6,Friuli-Venezia Giulia
2021-03-04,VDA,291,139,152,42,249,ITC,ITC2,2,Valle d'Aosta / Vallée d'Aoste
2021-05-10,ABR,10110,4787,5323,5459,4651,ITF,ITF1,13,Abruzzo
2021-05-18,FVG,10404,5199,5205,8419,1985,ITH,ITH4,6,Friuli-Venezia Giulia
2021-02-05,VDA,294,102,192,101,193,ITC,ITC2,2,Valle d'Aosta / Vallée d'Aoste
2021-03-06,VEN,10633,4320,6313,7365,3268,ITH,ITH3,5,Veneto
2021-04-17,VEN,22353,9062,13291,15071,7282,ITH,ITH3,5,Veneto
2021-04-29,VDA,1291,634,657,757,534,ITC,ITC2,2,Valle d'Aosta / Vallée d'Aoste
2021-01-06,PAB,59,18,41,59,0,ITH,ITH1,4,Provincia Autonoma Bolzano / Bozen
2021-01-18,FVG,1961,606,1355,1867,94,ITH,ITH4,6,Friuli-Venezia Giulia
2021-01-30,LAZ,7009,2891,4118,807,6202,ITI,ITI4,12,Lazio
2021-04-16,VDA,599,261,338,597,2,ITC,ITC2,2,Valle d'Aosta / Vallée d'Aoste
2021-05-21,FVG,9773,4368,5405,7452,2321,ITH,ITH4,6,Friuli-Venezia Giulia
2021-01-13,VDA,337,110,227,337,0,ITC,ITC2,2,Valle d'Aosta / Vallée d'Aoste
2021-02-16,UMB,1308,655,653,1299,9,ITI,ITI2,10,Umbria
2021-02-13,ABR,847,383,464,436,411,ITF,ITF1,13,Abruzzo
2021-02-13,FVG,567,179,388,561,6,ITH,ITH4,6,Friuli-Venezia Giulia
2021-02-26,BAS,2149,904,1245,2069,80,ITF,ITF5,17,Basilicata
2021-03-20,CAL,6453,2975,3478,4066,2387,ITF,ITF6,18,Calabria
2021-03-20,PAT,872,402,470,670,202,ITH,ITH2,4,Provincia Autonoma Trento
2021-03-22,TOS,4882,2443,2439,4438,444,ITI,ITI1,9,Toscana
2021-05-21,CAM,63354,29333,34021,43167,20187,ITF,ITF3,15,Campania
2021-01-20,LIG,1550,555,995,1538,12,ITC,ITC3,7,Liguria
2021-03-27,PIE,18360,7817,10543,9546,8814,ITC,ITC1,1,Piemonte
2021-01-29,VEN,9017,2787,6230,367,8650,ITH,ITH3,5,Veneto
2021-03-01,SAR,2162,1055,1107,1503,659,ITG,ITG2,20,Sardegna
2021-05-15,PAT,1565,814,751,677,888,ITH,ITH2,4,Provincia Autonoma Trento
2021-01-27,CAL,1456,733,723,396,1060,ITF,ITF6,18,Calabria
2021-01-27,PAT,802,277,525,91,711,ITH,ITH2,4,Provincia Autonoma Trento
2021-03-01,PIE,12038,4845,7193,11229,809,ITC,ITC1,1,Piemonte
2021-03-10,EMR,18680,7651,11029,13040,5640,ITH,ITH5,8,Emilia-Romagna
2021-04-08,TOS,29643,12529,17114,23270,6373,ITI,ITI1,9,Toscana
2021-04-20,MAR,10699,4996,5703,9282,1417,ITI,ITI3,11,Marche
2021-04-24,UMB,4560,1962,2598,3383,1177,ITI,ITI2,10,Umbria
2021-01-14,TOS,3255,1179,2076,3255,0,ITI,ITI1,9,Toscana
2021-02-28,MOL,829,331,498,787,42,ITF,ITF2,14,Molise
2021-04-03,LIG,5406,2498,2908,4463,943,ITC,ITC3,7,Liguria
2021-04-03,PAB,831,364,467,22,809,ITH,ITH1,4,Provincia Autonoma Bolzano / Bozen
2021-05-06,TOS,31203,13553,17650,14122,17081,ITI,ITI1,9,Toscana
2021-01-25,BAS,1023,429,594,74,949,ITF,ITF5,17,Basilicata
2021-04-10,VDA,404,190,214,399,5,ITC,ITC2,2,Valle d'Aosta / Vallée d'Aoste
2021-04-20,SIC,19259,9074,10185,13920,5339,ITG,ITG1,19,Sicilia
2021-03-13,MAR,5762,2652,3110,1805,3957,ITI,ITI3,11,Marche
2021-03-15,LAZ,19274,8330,10944,12535,6739,ITI,ITI4,12,Lazio
2021-04-22,UMB,5420,2228,3192,2761,2659,ITI,ITI2,10,Umbria
2021-01-29,PAT,1352,331,1021,55,1297,ITH,ITH2,4,Provincia Autonoma Trento
2021-02-02,LIG,2668,1005,1663,134,2534,ITC,ITC3,7,Liguria
2021-03-10,SAR,6010,2917,3093,5160,850,ITG,ITG2,20,Sardegna
2021-03-18,ABR,3896,1651,2245,2065,1831,ITF,ITF1,13,Abruzzo
2021-04-19,VDA,751,325,426,542,209,ITC,ITC2,2,Valle d'Aosta / Vallée d'Aoste
2021-01-23,TOS,3949,1354,2595,640,3309,ITI,ITI1,9,Toscana
2021-03-18,PUG,9400,4253,5147,3284,6116,ITF,ITF4,16,Puglia
2021-04-12,BAS,2174,1053,1121,1679,495,ITF,ITF5,17,Basilicata
2021-04-15,PAT,3179,1437,1742,3027,152,ITH,ITH2,4,Provincia Autonoma Trento
2021-04-30,UMB,6220,2959,3261,2836,3384,ITI,ITI2,10,Umbria
2021-05-21,LOM,92296,44672,47624,28650,63646,ITC,ITC4,3,Lombardia
2021-01-07,BAS,640,319,321,640,0,ITF,ITF5,17,Basilicata
2021-01-19,MAR,226,82,144,141,85,ITI,ITI3,11,Marche
2021-04-27,MOL,1590,765,825,462,1128,ITF,ITF2,14,Molise
2021-05-23,PUG,10640,4928,5712,8082,2558,ITF,ITF4,16,Puglia
2021-03-10,PAB,1261,524,737,1118,143,ITH,ITH1,4,Provincia Autonoma Bolzano / Bozen
2021-05-12,VDA,1137,549,588,467,670,ITC,ITC2,2,Valle d'Aosta / Vallée d'Aoste
2021-02-18,MOL,319,74,245,306,13,ITF,ITF2,14,Molise
2021-01-06,LIG,1660,616,1044,1660,0,ITC,ITC3,7,Liguria
2021-03-13,VDA,145,86,59,145,0,ITC,ITC2,2,Valle d'Aosta / Vallée d'Aoste
2021-05-05,SIC,26294,12173,14121,16703,9591,ITG,ITG1,19,Sicilia
2021-01-02,SIC,4879,2538,2341,4879,0,ITG,ITG1,19,Sicilia
2021-01-10,LIG,648,262,386,648,0,ITC,ITC3,7,Liguria
2021-05-13,PUG,37967,16881,21086,21071,16896,ITF,ITF4,16,Puglia
2021-05-18,PAT,4225,1995,2230,3395,830,ITH,ITH2,4,Provincia Autonoma Trento
2021-04-21,UMB,5301,2304,2997,3075,2226,ITI,ITI2,10,Umbria
2021-02-13,PUG,3726,1455,2271,3031,695,ITF,ITF4,16,Puglia
2021-03-03,VEN,12034,4591,7443,8540,3494,ITH,ITH3,5,Veneto
2021-01-26,MOL,450,184,266,8,442,ITF,ITF2,14,Molise
2021-02-17,UMB,1618,748,870,1267,351,ITI,ITI2,10,Umbria
2021-04-21,EMR,23844,10923,12921,14136,9708,ITH,ITH5,8,Emilia-Romagna
2021-04-28,SIC,29336,13765,15571,20265,9071,ITG,ITG1,19,Sicilia
2021-04-22,VEN,31881,13879,18002,16131,15750,ITH,ITH3,5,Veneto
2021-04-23,MAR,11156,5139,6017,8101,3055,ITI,ITI3,11,Marche
2021-02-01,FVG,2096,688,1408,16,2080,ITH,ITH4,6,Friuli-Venezia Giulia
2021-02-14,SIC,1058,403,655,918,140,ITG,ITG1,19,Sicilia
2021-03-21,ABR,2134,913,1221,843,1291,ITF,ITF1,13,Abruzzo
2021-05-07,VEN,47691,22886,24805,39101,8590,ITH,ITH3,5,Veneto
2021-05-16,CAL,13763,6717,7046,9958,3805,ITF,ITF6,18,Calabria
2021-05-18,CAL,15524,7771,7753,12059,3465,ITF,ITF6,18,Calabria
2021-02-23,BAS,1901,771,1130,1763,138,ITF,ITF5,17,Basilicata
2021-03-11,MAR,6594,2784,3810,5224,1370,ITI,ITI3,11,Marche
2021-05-16,PAT,1302,717,585,1064,238,ITH,ITH2,4,Provincia Autonoma Trento
2021-05-03,SIC,23458,10820,12638,13573,9885,ITG,ITG1,19,Sicilia
2020-12-27,ABR,37,19,18,37,0,ITF,ITF1,13,Abruzzo
2021-01-06,EMR,8265,2943,5322,8265,0,ITH,ITH5,8,Emilia-Romagna
2021-01-11,LAZ,5529,2104,3425,5529,0,ITI,ITI4,12,Lazio
2021-01-21,PUG,2132,904,1228,1271,861,ITF,ITF4,16,Puglia
2021-02-09,SAR,2286,837,1449,1290,996,ITG,ITG2,20,Sardegna
2021-04-07,LIG,13585,6032,7553,11296,2289,ITC,ITC3,7,Liguria
2021-04-14,LAZ,29214,13241,15973,19095,10119,ITI,ITI4,12,Lazio
2021-04-24,CAL,18927,9446,9481,15533,3394,ITF,ITF6,18,Calabria
2021-01-31,EMR,7695,2761,4934,241,7454,ITH,ITH5,8,Emilia-Romagna
2021-02-15,TOS,8770,3375,5395,7945,825,ITI,ITI1,9,Toscana
2021-03-05,CAL,6136,3536,2600,5564,572,ITF,ITF6,18,Calabria
2021-03-14,EMR,8693,3744,4949,4897,3796,ITH,ITH5,8,Emilia-Romagna
2021-01-22,PUG,1409,578,831,991,418,ITF,ITF4,16,Puglia
2021-04-24,CAM,36307,17510,18797,25069,11238,ITF,ITF3,15,Campania
2021-05-02,VDA,765,345,420,605,160,ITC,ITC2,2,Valle d'Aosta / Vallée d'Aoste
2021-05-17,LOM,94281,45203,49078,30100,64181,ITC,ITC4,3,Lombardia
2021-01-28,LIG,2847,971,1876,39,2808,ITC,ITC3,7,Liguria
2021-03-19,TOS,10136,4457,5679,7271,2865,ITI,ITI1,9,Toscana
2021-03-04,TOS,17622,6757,10865,14540,3082,ITI,ITI1,9,Toscana
2021-04-03,UMB,2110,716,1394,1057,1053,ITI,ITI2,10,Umbria
2021-04-21,LOM,71638,32501,39137,57049,14589,ITC,ITC4,3,Lombardia
2021-02-16,CAM,5438,2411,3027,4667,771,ITF,ITF3,15,Campania
2021-04-14,TOS,20136,8324,11812,15037,5099,ITI,ITI1,9,Toscana
2021-03-11,SIC,15452,6519,8933,12887,2565,ITG,ITG1,19,Sicilia
2021-04-21,CAM,30214,14720,15494,17989,12225,ITF,ITF3,15,Campania
2021-05-01,SIC,24489,11337,13152,19329,5160,ITG,ITG1,19,Sicilia
2021-02-16,PIE,3966,1755,2211,3208,758,ITC,ITC1,1,Piemonte
2021-04-03,EMR,19931,8763,11168,16193,3738,ITH,ITH5,8,Emilia-Romagna
2021-04-18,LOM,36328,16201,20127,31101,5227,ITC,ITC4,3,Lombardia
2021-03-31,PIE,19105,8102,11003,10413,8692,ITC,ITC1,1,Piemonte
2021-05-13,PAT,3374,1567,1807,2291,1083,ITH,ITH2,4,Provincia Autonoma Trento
2021-02-02,SIC,5544,2624,2920,634,4910,ITG,ITG1,19,Sicilia
2021-02-10,PUG,3643,1435,2208,2133,1510,ITF,ITF4,16,Puglia
2021-01-25,CAM,5744,2926,2818,164,5580,ITF,ITF3,15,Campania
2021-03-27,VDA,333,164,169,302,31,ITC,ITC2,2,Valle d'Aosta / Vallée d'Aoste
2021-04-17,ABR,7346,3398,3948,4293,3053,ITF,ITF1,13,Abruzzo
2021-04-21,CAL,11474,5777,5697,8568,2906,ITF,ITF6,18,Calabria
2021-05-11,PIE,31843,15351,16492,18751,13092,ITC,ITC1,1,Piemonte
2021-03-08,PUG,14599,6081,8518,12201,2398,ITF,ITF4,16,Puglia
2021-03-17,LOM,26233,10482,15751,15244,10989,ITC,ITC4,3,Lombardia
2021-02-14,PIE,1476,498,978,876,600,ITC,ITC1,1,Piemonte
2021-02-17,LOM,11969,3746,8223,10580,1389,ITC,ITC4,3,Lombardia
2021-02-25,EMR,9228,3497,5731,8274,954,ITH,ITH5,8,Emilia-Romagna
2021-02-28,VEN,4136,1389,2747,3299,837,ITH,ITH3,5,Veneto
2021-05-17,CAL,15079,7535,7544,10359,4720,ITF,ITF6,18,Calabria
2021-01-26,VEN,6917,2091,4826,153,6764,ITH,ITH3,5,Veneto
2021-02-27,CAM,13950,4473,9477,12308,1642,ITF,ITF3,15,Campania
2021-03-07,LAZ,14092,5430,8662,10499,3593,ITI,ITI4,12,Lazio
2021-04-13,SAR,7603,3592,4011,5778,1825,ITG,ITG2,20,Sardegna
2021-04-19,TOS,9087,4502,4585,8060,1027,ITI,ITI1,9,Toscana
2021-02-18,CAM,9080,3812,5268,8372,708,ITF,ITF3,15,Campania
2021-02-28,CAL,2166,983,1183,2015,151,ITF,ITF6,18,Calabria
2021-04-13,EMR,23565,11036,12529,19280,4285,ITH,ITH5,8,Emilia-Romagna
2021-04-20,MOL,2311,1020,1291,1219,1092,ITF,ITF2,14,Molise
2021-05-07,ABR,12200,5706,6494,7770,4430,ITF,ITF1,13,Abruzzo
2021-02-04,VEN,7326,2017,5309,553,6773,ITH,ITH3,5,Veneto
2021-04-19,LAZ,30047,13655,16392,19386,10661,ITI,ITI4,12,Lazio
2020-12-27,LOM,717,413,304,717,0,ITC,ITC4,3,Lombardia
2021-01-09,PUG,4885,2250,2635,4885,0,ITF,ITF4,16,Puglia
2021-03-10,VEN,18932,8634,10298,13248,5684,ITH,ITH3,5,Veneto
2021-05-02,MAR,8898,3936,4962,3160,5738,ITI,ITI3,11,Marche
2021-05-07,PUG,49065,21876,27189,25890,23175,ITF,ITF4,16,Puglia
2021-03-29,PAT,2455,957,1498,1720,735,ITH,ITH2,4,Provincia Autonoma Trento
2021-05-08,PUG,53656,22689,30967,24132,29524,ITF,ITF4,16,Puglia
2021-02-05,MAR,2155,653,1502,440,1715,ITI,ITI3,11,Marche
2021-04-16,MAR,10081,4702,5379,9556,525,ITI,ITI3,11,Marche
2021-05-17,VEN,26250,12890,13360,16381,9869,ITH,ITH3,5,Veneto
2021-02-17,CAM,7388,3210,4178,6328,1060,ITF,ITF3,15,Campania
2021-03-08,FVG,4065,1594,2471,1977,2088,ITH,ITH4,6,Friuli-Venezia Giulia
2021-03-30,MAR,7418,3044,4374,4603,2815,ITI,ITI3,11,Marche
2021-04-28,MOL,1672,903,769,455,1217,ITF,ITF2,14,Molise
2021-04-29,TOS,39331,17706,21625,19223,20108,ITI,ITI1,9,Toscana
2021-05-13,TOS,34687,15223,19464,13698,20989,ITI,ITI1,9,Toscana
2021-05-17,PAB,3109,1499,1610,2425,684,ITH,ITH1,4,Provincia Autonoma Bolzano / Bozen
2021-02-21,SAR,1589,710,879,1559,30,ITG,ITG2,20,Sardegna
2021-03-01,ABR,3477,1384,2093,2725,752,ITF,ITF1,13,Abruzzo
2021-01-13,LAZ,5670,2145,3525,5670,0,ITI,ITI4,12,Lazio
2021-03-17,EMR,13714,5690,8024,5869,7845,ITH,ITH5,8,Emilia-Romagna
2021-04-18,CAL,5771,2760,3011,4892,879,ITF,ITF6,18,Calabria
2021-05-09,LIG,2820,1242,1578,1110,1710,ITC,ITC3,7,Liguria
2021-05-22,SIC,45702,21579,24123,26755,18947,ITG,ITG1,19,Sicilia
2021-01-09,PIE,6184,2185,3999,6184,0,ITC,ITC1,1,Piemonte
2021-02-02,EMR,9479,3049,6430,526,8953,ITH,ITH5,8,Emilia-Romagna
2021-02-24,PIE,11409,4629,6780,10904,505,ITC,ITC1,1,Piemonte
2021-01-09,CAM,10567,5024,5543,10567,0,ITF,ITF3,15,Campania
2021-01-17,TOS,2535,871,1664,2022,513,ITI,ITI1,9,Toscana
2021-02-12,FVG,1193,428,765,1146,47,ITH,ITH4,6,Friuli-Venezia Giulia
2021-04-22,ABR,6664,3193,3471,4983,1681,ITF,ITF1,13,Abruzzo
2021-04-30,FVG,7277,3206,4071,3672,3605,ITH,ITH4,6,Friuli-Venezia Giulia
2021-05-14,PAB,5086,2289,2797,3071,2015,ITH,ITH1,4,Provincia Autonoma Bolzano / Bozen
2021-03-10,PAT,2411,928,1483,1490,921,ITH,ITH2,4,Provincia Autonoma Trento
2021-05-05,MOL,2413,1042,1371,2272,141,ITF,ITF2,14,Molise
2021-01-31,SAR,2121,750,1371,48,2073,ITG,ITG2,20,Sardegna
2021-03-08,ABR,5122,1666,3456,4150,972,ITF,ITF1,13,Abruzzo
2021-01-21,CAL,960,445,515,930,30,ITF,ITF6,18,Calabria
2021-04-15,FVG,6486,2859,3627,5216,1270,ITH,ITH4,6,Friuli-Venezia Giulia
2021-05-07,PAT,5965,3066,2899,5131,834,ITH,ITH2,4,Provincia Autonoma Trento
2021-02-15,PUG,3252,1268,1984,2632,620,ITF,ITF4,16,Puglia
2021-04-14,VDA,941,430,511,717,224,ITC,ITC2,2,Valle d'Aosta / Vallée d'Aoste
2021-01-09,PAT,190,40,150,190,0,ITH,ITH2,4,Provincia Autonoma Trento
2021-04-19,MAR,9602,4497,5105,8022,1580,ITI,ITI3,11,Marche
2021-01-07,PIE,5387,1739,3648,5387,0,ITC,ITC1,1,Piemonte
2021-03-28,TOS,6199,2801,3398,5945,254,ITI,ITI1,9,Toscana
2021-03-14,CAL,2544,1020,1524,2142,402,ITF,ITF6,18,Calabria
2021-03-31,ABR,6647,2878,3769,4580,2067,ITF,ITF1,13,Abruzzo
2021-04-15,VDA,810,377,433,671,139,ITC,ITC2,2,Valle d'Aosta / Vallée d'Aoste
2021-01-11,PAB,1569,513,1056,1569,0,ITH,ITH1,4,Provincia Autonoma Bolzano / Bozen
2021-02-09,VEN,5246,1890,3356,3446,1800,ITH,ITH3,5,Veneto
2021-03-03,BAS,1743,813,930,1186,557,ITF,ITF5,17,Basilicata
2021-05-19,LAZ,46327,21146,25181,36563,9764,ITI,ITI4,12,Lazio
2021-03-29,PUG,12857,5996,6861,6135,6722,ITF,ITF4,16,Puglia
2020-12-28,SIC,211,126,85,211,0,ITG,ITG1,19,Sicilia
2021-01-02,LIG,691,245,446,691,0,ITC,ITC3,7,Liguria
2021-01-11,SIC,5911,2596,3315,5911,0,ITG,ITG1,19,Sicilia
2021-04-09,LIG,12405,5550,6855,10677,1728,ITC,ITC3,7,Liguria
2021-05-11,PUG,31999,14077,17922,13789,18210,ITF,ITF4,16,Puglia
2021-04-24,EMR,28564,13210,15354,14357,14207,ITH,ITH5,8,Emilia-Romagna
2021-05-04,FVG,9484,4278,5206,6142,3342,ITH,ITH4,6,Friuli-Venezia Giulia
2021-03-24,SIC,21143,9907,11236,15306,5837,ITG,ITG1,19,Sicilia
2021-05-05,LIG,13680,6124,7556,5269,8411,ITC,ITC3,7,Liguria
2021-03-03,ABR,4619,1877,2742,3713,906,ITF,ITF1,13,Abruzzo
2021-04-17,BAS,3461,1655,1806,2199,1262,ITF,ITF5,17,Basilicata
2021-01-02,PAB,91,48,43,91,0,ITH,ITH1,4,Provincia Autonoma Bolzano / Bozen
2021-03-15,MOL,832,338,494,587,245,ITF,ITF2,14,Molise
2021-03-19,PUG,7950,3647,4303,3407,4543,ITF,ITF4,16,Puglia
2021-04-09,PAB,2926,1292,1634,2196,730,ITH,ITH1,4,Provincia Autonoma Bolzano / Bozen
2021-01-13,MAR,2105,746,1359,2105,0,ITI,ITI3,11,Marche
2021-01-26,EMR,8334,3000,5334,215,8119,ITH,ITH5,8,Emilia-Romagna
2021-02-04,LOM,27654,8072,19582,1971,25683,ITC,ITC4,3,Lombardia
2021-01-11,LIG,2654,990,1664,2654,0,ITC,ITC3,7,Liguria
2021-02-14,PAB,297,130,167,297,0,ITH,ITH1,4,Provincia Autonoma Bolzano / Bozen
2021-04-04,BAS,610,225,385,197,413,ITF,ITF5,17,Basilicata
2021-04-17,PAT,2201,1119,1082,2144,57,ITH,ITH2,4,Provincia Autonoma Trento
2021-03-01,UMB,1503,774,729,1389,114,ITI,ITI2,10,Umbria
2021-01-31,VEN,4766,1562,3204,392,4374,ITH,ITH3,5,Veneto
2021-02-09,CAL,2145,904,1241,947,1198,ITF,ITF6,18,Calabria
2021-05-19,TOS,27579,13350,14229,18796,8783,ITI,ITI1,9,Toscana
2021-01-09,VEN,7927,2538,5389,7927,0,ITH,ITH3,5,Veneto
2021-05-07,CAL,15879,7483,8396,9679,6200,ITF,ITF6,18,Calabria
2021-02-24,PAT,1318,523,795,922,396,ITH,ITH2,4,Provincia Autonoma Trento
2021-03-07,VDA,64,30,34,11,53,ITC,ITC2,2,Valle d'Aosta / Vallée d'Aoste
2021-05-17,SAR,11856,5560,6296,8968,2888,ITG,ITG2,20,Sardegna
2021-05-22,LAZ,52678,25573,27105,42884,9794,ITI,ITI4,12,Lazio
2021-02-06,MAR,2459,900,1559,522,1937,ITI,ITI3,11,Marche
2021-05-07,BAS,4632,2276,2356,3281,1351,ITF,ITF5,17,Basilicata
2021-01-09,CAL,1918,1037,881,1918,0,ITF,ITF6,18,Calabria
2021-01-22,PAT,1668,433,1235,329,1339,ITH,ITH2,4,Provincia Autonoma Trento
2021-03-17,VEN,14642,5991,8651,7848,6794,ITH,ITH3,5,Veneto
2021-04-13,VEN,14012,6315,7697,8522,5490,ITH,ITH3,5,Veneto
2021-01-08,CAM,10455,4968,5487,10455,0,ITF,ITF3,15,Campania
2021-05-17,PIE,30462,14294,16168,17608,12854,ITC,ITC1,1,Piemonte
2021-01-26,SAR,1336,453,883,27,1309,ITG,ITG2,20,Sardegna
2021-04-11,CAM,17522,8605,8917,15440,2082,ITF,ITF3,15,Campania
2021-04-26,TOS,10143,4936,5207,7591,2552,ITI,ITI1,9,Toscana
2021-02-04,EMR,9931,3203,6728,1250,8681,ITH,ITH5,8,Emilia-Romagna
2021-02-16,PAT,663,244,419,658,5,ITH,ITH2,4,Provincia Autonoma Trento
2021-02-19,MOL,169,93,76,167,2,ITF,ITF2,14,Molise
2021-02-21,VEN,4634,1209,3425,4629,5,ITH,ITH3,5,Veneto
2021-04-11,CAL,4085,1864,2221,2144,1941,ITF,ITF6,18,Calabria
2021-05-16,FVG,9930,4753,5177,8539,1391,ITH,ITH4,6,Friuli-Venezia Giulia
2020-12-30,PAB,388,182,206,388,0,ITH,ITH1,4,Provincia Autonoma Bolzano / Bozen
2021-01-15,SIC,5085,2233,2852,5085,0,ITG,ITG1,19,Sicilia
2021-03-06,BAS,1352,535,817,757,595,ITF,ITF5,17,Basilicata
2021-03-07,SIC,9269,3455,5814,8186,1083,ITG,ITG1,19,Sicilia
2021-01-22,BAS,67,24,43,67,0,ITF,ITF5,17,Basilicata
2021-04-22,BAS,5036,2345,2691,3434,1602,ITF,ITF5,17,Basilicata
2021-01-18,VDA,213,74,139,213,0,ITC,ITC2,2,Valle d'Aosta / Vallée d'Aoste
2021-01-28,MOL,613,217,396,17,596,ITF,ITF2,14,Molise
2021-02-23,ABR,2782,1275,1507,2771,11,ITF,ITF1,13,Abruzzo
2021-03-31,LOM,41917,16965,24952,26735,15182,ITC,ITC4,3,Lombardia
2021-03-10,ABR,4947,1638,3309,3990,957,ITF,ITF1,13,Abruzzo
2021-01-05,UMB,854,429,425,854,0,ITI,ITI2,10,Umbria
2021-03-14,VEN,15165,5934,9231,14271,894,ITH,ITH3,5,Veneto
2021-02-28,SAR,368,169,199,142,226,ITG,ITG2,20,Sardegna
2021-03-08,PAT,1398,433,965,1045,353,ITH,ITH2,4,Provincia Autonoma Trento
2021-02-15,BAS,621,232,389,580,41,ITF,ITF5,17,Basilicata
2021-05-13,SAR,11906,5524,6382,8631,3275,ITG,ITG2,20,Sardegna
2021-02-22,LAZ,11458,4991,6467,10956,502,ITI,ITI4,12,Lazio
2021-03-04,ABR,5935,2358,3577,5013,922,ITF,ITF1,13,Abruzzo
2021-03-13,PUG,10374,4100,6274,8642,1732,ITF,ITF4,16,Puglia
2021-04-01,UMB,4330,1792,2538,2323,2007,ITI,ITI2,10,Umbria
2021-02-08,PAB,2,1,1,1,1,ITH,ITH1,4,Provincia Autonoma Bolzano / Bozen
2021-05-14,SAR,13398,6102,7296,10288,3110,ITG,ITG2,20,Sardegna
2021-05-15,PIE,33470,15611,17859,19901,13569,ITC,ITC1,1,Piemonte
2021-03-03,CAL,4862,2651,2211,3801,1061,ITF,ITF6,18,Calabria
2021-04-19,LOM,60070,27331,32739,50665,9405,ITC,ITC4,3,Lombardia
2021-04-27,EMR,29834,13799,16035,17381,12453,ITH,ITH5,8,Emilia-Romagna
2021-01-14,PAB,1946,575,1371,1946,0,ITH,ITH1,4,Provincia Autonoma Bolzano / Bozen
2021-02-09,PIE,7351,2309,5042,722,6629,ITC,ITC1,1,Piemonte
2021-04-24,ABR,8711,3970,4741,7179,1532,ITF,ITF1,13,Abruzzo
2021-01-19,PUG,1221,452,769,1211,10,ITF,ITF4,16,Puglia
2021-02-07,VEN,2315,862,1453,714,1601,ITH,ITH3,5,Veneto
2021-03-18,VDA,136,43,93,99,37,ITC,ITC2,2,Valle d'Aosta / Vallée d'Aoste
2021-04-26,CAL,10251,5155,5096,7880,2371,ITF,ITF6,18,Calabria
2021-03-22,LAZ,21692,9062,12630,15031,6661,ITI,ITI4,12,Lazio
2021-05-04,TOS,18263,8188,10075,12827,5436,ITI,ITI1,9,Toscana
2021-05-20,PIE,37830,17501,20329,13288,24542,ITC,ITC1,1,Piemonte
2021-01-23,PAT,577,334,243,388,189,ITH,ITH2,4,Provincia Autonoma Trento
2020-12-30,VEN,699,245,454,699,0,ITH,ITH3,5,Veneto
2021-02-24,LAZ,12048,5205,6843,11054,994,ITI,ITI4,12,Lazio
2021-02-26,PAT,1218,435,783,923,295,ITH,ITH2,4,Provincia Autonoma Trento
2021-04-17,CAL,10647,4993,5654,8933,1714,ITF,ITF6,18,Calabria
2021-02-28,SIC,7177,3068,4109,6547,630,ITG,ITG1,19,Sicilia
2021-03-29,PAB,1170,499,671,411,759,ITH,ITH1,4,Provincia Autonoma Bolzano / Bozen
2021-04-02,LAZ,28530,13368,15162,21204,7326,ITI,ITI4,12,Lazio
2021-04-06,CAL,7213,3243,3970,4131,3082,ITF,ITF6,18,Calabria
2021-01-17,SAR,860,277,583,859,1,ITG,ITG2,20,Sardegna
2021-03-10,MAR,5667,2401,3266,4530,1137,ITI,ITI3,11,Marche
2021-03-20,LAZ,18225,6810,11415,12341,5884,ITI,ITI4,12,Lazio
2021-04-19,ABR,6226,2856,3370,3855,2371,ITF,ITF1,13,Abruzzo
2021-03-17,PUG,10273,4683,5590,4170,6103,ITF,ITF4,16,Puglia
2021-03-26,SIC,18001,8366,9635,12470,5531,ITG,ITG1,19,Sicilia
2021-04-10,LAZ,23800,10310,13490,16619,7181,ITI,ITI4,12,Lazio
2021-05-15,BAS,6509,3331,3178,3944,2565,ITF,ITF5,17,Basilicata
2021-03-19,SAR,7265,3047,4218,5052,2213,ITG,ITG2,20,Sardegna
2021-03-20,UMB,2297,832,1465,2272,25,ITI,ITI2,10,Umbria
2021-04-02,TOS,31938,13528,18410,23914,8024,ITI,ITI1,9,Toscana
2021-02-11,SIC,5321,2097,3224,4858,463,ITG,ITG1,19,Sicilia
2021-03-16,LAZ,13536,5731,7805,7093,6443,ITI,ITI4,12,Lazio
2021-04-07,PAT,2597,1011,1586,1656,941,ITH,ITH2,4,Provincia Autonoma Trento
2021-04-08,PAT,3114,1294,1820,1996,1118,ITH,ITH2,4,Provincia Autonoma Trento
2021-04-10,FVG,4981,2160,2821,3759,1222,ITH,ITH4,6,Friuli-Venezia Giulia
2021-04-24,LOM,75605,33507,42098,54546,21059,ITC,ITC4,3,Lombardia
2020-12-30,LAZ,1630,629,1001,1630,0,ITI,ITI4,12,Lazio
2021-04-02,FVG,6566,2915,3651,4733,1833,ITH,ITH4,6,Friuli-Venezia Giulia
2021-04-26,LAZ,29123,13391,15732,19923,9200,ITI,ITI4,12,Lazio
2021-03-15,TOS,8356,3331,5025,3914,4442,ITI,ITI1,9,Toscana
2021-04-03,TOS,15011,6644,8367,13885,1126,ITI,ITI1,9,Toscana
2021-05-17,SIC,32127,15454,16673,19336,12791,ITG,ITG1,19,Sicilia
2021-01-27,PIE,4196,1453,2743,999,3197,ITC,ITC1,1,Piemonte
2021-02-04,CAL,3392,1624,1768,644,2748,ITF,ITF6,18,Calabria
2021-04-30,PIE,31635,14196,17439,18358,13277,ITC,ITC1,1,Piemonte
2021-02-18,TOS,8818,3285,5533,7923,895,ITI,ITI1,9,Toscana
2021-03-02,PUG,16324,6056,10268,15027,1297,ITF,ITF4,16,Puglia
2021-04-09,LAZ,27239,12238,15001,19022,8217,ITI,ITI4,12,Lazio
2021-05-23,ABR,6817,3229,3588,4895,1922,ITF,ITF1,13,Abruzzo
2021-03-15,PAB,1192,451,741,710,482,ITH,ITH1,4,Provincia Autonoma Bolzano / Bozen
2021-03-19,PAB,1906,773,1133,799,1107,ITH,ITH1,4,Provincia Autonoma Bolzano / Bozen
2021-04-18,ABR,5811,2726,3085,4869,942,ITF,ITF1,13,Abruzzo
2021-01-16,SAR,1492,525,967,1492,0,ITG,ITG2,20,Sardegna
2021-02-24,UMB,1520,565,955,1505,15,ITI,ITI2,10,Umbria
2021-01-14,LIG,2981,1055,1926,2981,0,ITC,ITC3,7,Liguria
2021-01-18,MAR,673,230,443,547,126,ITI,ITI3,11,Marche
2021-04-29,CAM,41267,20002,21265,24803,16464,ITF,ITF3,15,Campania
2021-02-06,CAL,2906,1337,1569,442,2464,ITF,ITF6,18,Calabria
2021-04-25,SAR,4441,2242,2199,3662,779,ITG,ITG2,20,Sardegna
2021-01-24,ABR,50,22,28,6,44,ITF,ITF1,13,Abruzzo
2021-02-27,MOL,1366,568,798,1347,19,ITF,ITF2,14,Molise
2021-01-04,VEN,6735,2033,4702,6735,0,ITH,ITH3,5,Veneto
2021-02-02,PAB,1745,506,1239,8,1737,ITH,ITH1,4,Provincia Autonoma Bolzano / Bozen
2021-03-10,MOL,1737,720,1017,1687,50,ITF,ITF2,14,Molise
2021-05-18,CAM,52035,23140,28895,32506,19529,ITF,ITF3,15,Campania
2021-03-01,FVG,2958,1041,1917,2906,52,ITH,ITH4,6,Friuli-Venezia Giulia
2021-01-02,VDA,6,5,1,6,0,ITC,ITC2,2,Valle d'Aosta / Vallée d'Aoste
2021-01-04,PUG,4505,2014,2491,4505,0,ITF,ITF4,16,Puglia
2021-02-19,MAR,1962,712,1250,1827,135,ITI,ITI3,11,Marche
2021-03-13,SIC,12416,5475,6941,7833,4583,ITG,ITG1,19,Sicilia
2021-03-17,PAT,2067,790,1277,1199,868,ITH,ITH2,4,Provincia Autonoma Trento
2021-03-30,MOL,2003,857,1146,1491,512,ITF,ITF2,14,Molise
2021-04-07,PUG,15265,6751,8514,8597,6668,ITF,ITF4,16,Puglia
2021-04-26,SAR,6819,3263,3556,5944,875,ITG,ITG2,20,Sardegna
2021-05-10,TOS,26066,12314,13752,15475,10591,ITI,ITI1,9,Toscana
2021-05-14,UMB,5221,2430,2791,3417,1804,ITI,ITI2,10,Umbria
2021-05-18,VDA,967,483,484,352,615,ITC,ITC2,2,Valle d'Aosta / Vallée d'Aoste
2021-01-06,PIE,3116,1111,2005,3116,0,ITC,ITC1,1,Piemonte
2021-01-29,FVG,2414,814,1600,264,2150,ITH,ITH4,6,Friuli-Venezia Giulia
2021-03-13,BAS,1794,888,906,749,1045,ITF,ITF5,17,Basilicata
2021-04-01,SAR,10101,4026,6075,7088,3013,ITG,ITG2,20,Sardegna
2021-04-07,SIC,15555,7636,7919,8391,7164,ITG,ITG1,19,Sicilia
2021-05-03,MOL,2480,1162,1318,2317,163,ITF,ITF2,14,Molise
2021-05-12,SIC,36805,17333,19472,21868,14937,ITG,ITG1,19,Sicilia
2021-02-16,LIG,2397,954,1443,2004,393,ITC,ITC3,7,Liguria
2021-03-15,EMR,13238,6065,7173,6743,6495,ITH,ITH5,8,Emilia-Romagna
2021-04-16,CAL,10125,4953,5172,8528,1597,ITF,ITF6,18,Calabria
2021-05-08,LOM,87123,40479,46644,65646,21477,ITC,ITC4,3,Lombardia
2021-05-13,UMB,5871,2644,3227,3800,2071,ITI,ITI2,10,Umbria
2021-01-21,TOS,1589,686,903,867,722,ITI,ITI1,9,Toscana
2021-02-06,VDA,289,104,185,92,197,ITC,ITC2,2,Valle d'Aosta / Vallée d'Aoste
2021-02-18,MAR,2101,745,1356,1815,286,ITI,ITI3,11,Marche
2021-01-31,ABR,1501,487,1014,286,1215,ITF,ITF1,13,Abruzzo
2021-04-17,MOL,1691,826,865,963,728,ITF,ITF2,14,Molise
2021-03-02,PAT,1304,440,864,928,376,ITH,ITH2,4,Provincia Autonoma Trento
2021-03-22,FVG,3540,1343,2197,1586,1954,ITH,ITH4,6,Friuli-Venezia Giulia
2021-04-05,LOM,27388,11697,15691,19278,8110,ITC,ITC4,3,Lombardia
2021-04-06,SIC,17869,8541,9328,13544,4325,ITG,ITG1,19,Sicilia
2021-04-25,CAL,15814,8026,7788,14696,1118,ITF,ITF6,18,Calabria
2021-01-22,MOL,126,35,91,126,0,ITF,ITF2,14,Molise
2021-02-08,UMB,637,203,434,88,549,ITI,ITI2,10,Umbria
2021-05-11,CAM,39865,19243,20622,30497,9368,ITF,ITF3,15,Campania
2021-01-17,LAZ,4894,2028,2866,4682,212,ITI,ITI4,12,Lazio
2021-05-21,TOS,27520,12686,14834,16592,10928,ITI,ITI1,9,Toscana
2021-01-15,PAB,3282,1228,2054,3282,0,ITH,ITH1,4,Provincia Autonoma Bolzano / Bozen
2021-03-29,EMR,21177,9427,11750,16531,4646,ITH,ITH5,8,Emilia-Romagna
2021-01-31,LOM,9746,3763,5983,34,9712,ITC,ITC4,3,Lombardia
2021-02-05,CAL,3798,1709,2089,489,3309,ITF,ITF6,18,Calabria
2021-03-27,MAR,7377,3072,4305,5019,2358,ITI,ITI3,11,Marche
2021-01-16,SIC,2778,1196,1582,2778,0,ITG,ITG1,19,Sicilia
2021-02-04,SIC,6931,3186,3745,1455,5476,ITG,ITG1,19,Sicilia
2021-04-28,LAZ,32825,14987,17838,21281,11544,ITI,ITI4,12,Lazio
2021-05-13,LAZ,49379,22119,27260,31816,17563,ITI,ITI4,12,Lazio
2021-01-28,PUG,5471,2277,3194,472,4999,ITF,ITF4,16,Puglia
2021-02-27,VDA,231,85,146,124,107,ITC,ITC2,2,Valle d'Aosta / Vallée d'Aoste
2021-05-15,ABR,11338,5135,6203,6044,5294,ITF,ITF1,13,Abruzzo
2021-01-14,CAM,7073,2977,4096,7073,0,ITF,ITF3,15,Campania
2021-01-18,VEN,2762,776,1986,2563,199,ITH,ITH3,5,Veneto
2021-01-27,ABR,1364,515,849,39,1325,ITF,ITF1,13,Abruzzo
2021-02-10,MAR,1439,452,987,1080,359,ITI,ITI3,11,Marche
2021-01-09,LIG,1335,481,854,1335,0,ITC,ITC3,7,Liguria
2021-02-09,BAS,491,213,278,316,175,ITF,ITF5,17,Basilicata
2020-12-29,LAZ,488,176,312,488,0,ITI,ITI4,12,Lazio
2021-01-10,EMR,7130,2665,4465,7130,0,ITH,ITH5,8,Emilia-Romagna
2021-03-09,ABR,5168,1795,3373,4229,939,ITF,ITF1,13,Abruzzo
2021-03-13,PAT,830,380,450,782,48,ITH,ITH2,4,Provincia Autonoma Trento
2021-03-25,BAS,1879,601,1278,1533,346,ITF,ITF5,17,Basilicata
2021-05-05,VDA,1036,565,471,456,580,ITC,ITC2,2,Valle d'Aosta / Vallée d'Aoste
2021-05-06,CAM,57241,27886,29355,42799,14442,ITF,ITF3,15,Campania
2021-01-17,CAL,867,418,449,801,66,ITF,ITF6,18,Calabria
2021-04-11,PUG,16434,7236,9198,14778,1656,ITF,ITF4,16,Puglia
2020-12-31,VEN,3219,1042,2177,3219,0,ITH,ITH3,5,Veneto
2021-05-12,PAT,3292,1489,1803,2110,1182,ITH,ITH2,4,Provincia Autonoma Trento
2021-01-09,PAB,612,326,286,612,0,ITH,ITH1,4,Provincia Autonoma Bolzano / Bozen
2021-02-27,CAL,3669,1907,1762,3291,378,ITF,ITF6,18,Calabria
2021-03-20,SAR,5193,2073,3120,2916,2277,ITG,ITG2,20,Sardegna
2021-04-06,SAR,7445,3113,4332,5018,2427,ITG,ITG2,20,Sardegna
2021-04-05,VEN,19136,8367,10769,13696,5440,ITH,ITH3,5,Veneto
2021-02-03,PUG,5036,2005,3031,730,4306,ITF,ITF4,16,Puglia
2021-03-16,BAS,1900,799,1101,228,1672,ITF,ITF5,17,Basilicata
2021-04-04,SIC,6831,3329,3502,5539,1292,ITG,ITG1,19,Sicilia
2021-01-22,VDA,56,21,35,20,36,ITC,ITC2,2,Valle d'Aosta / Vallée d'Aoste
2021-01-23,PUG,3040,1294,1746,886,2154,ITF,ITF4,16,Puglia
2021-02-26,PUG,13709,5026,8683,12678,1031,ITF,ITF4,16,Puglia
2021-05-05,CAL,13579,6506,7073,8473,5106,ITF,ITF6,18,Calabria
2021-01-23,SIC,4242,2190,2052,217,4025,ITG,ITG1,19,Sicilia
2021-02-01,VEN,8557,2500,6057,161,8396,ITH,ITH3,5,Veneto
2021-02-01,LOM,16055,5316,10739,305,15750,ITC,ITC4,3,Lombardia
2021-02-25,CAM,12425,4478,7947,11237,1188,ITF,ITF3,15,Campania
2021-03-31,FVG,8030,3500,4530,7185,845,ITH,ITH4,6,Friuli-Venezia Giulia
2021-04-13,MOL,1615,710,905,1028,587,ITF,ITF2,14,Molise
2021-01-12,EMR,9410,3111,6299,9410,0,ITH,ITH5,8,Emilia-Romagna
2021-01-19,VEN,1309,472,837,1159,150,ITH,ITH3,5,Veneto
2021-02-24,SAR,2412,1293,1119,2223,189,ITG,ITG2,20,Sardegna
2021-03-27,TOS,8852,4143,4709,8637,215,ITI,ITI1,9,Toscana
2021-04-17,MAR,11700,5317,6383,10625,1075,ITI,ITI3,11,Marche
2021-01-09,BAS,557,160,397,557,0,ITF,ITF5,17,Basilicata
2021-01-31,MAR,1920,770,1150,105,1815,ITI,ITI3,11,Marche
2021-05-19,SAR,14356,7030,7326,11295,3061,ITG,ITG2,20,Sardegna
2021-02-15,PIE,4432,1597,2835,3227,1205,ITC,ITC1,1,Piemonte
2021-01-16,UMB,221,73,148,221,0,ITI,ITI2,10,Umbria
2021-03-03,LIG,4582,1847,2735,3556,1026,ITC,ITC3,7,Liguria
2021-04-08,PUG,17430,7561,9869,11258,6172,ITF,ITF4,16,Puglia
2021-01-15,TOS,3878,1347,2531,3878,0,ITI,ITI1,9,Toscana
2021-03-12,VEN,18570,8123,10447,11822,6748,ITH,ITH3,5,Veneto
2021-03-23,ABR,4782,2143,2639,2216,2566,ITF,ITF1,13,Abruzzo
2021-01-14,MAR,2010,692,1318,2010,0,ITI,ITI3,11,Marche
2021-03-28,SAR,4619,1814,2805,4540,79,ITG,ITG2,20,Sardegna
2021-01-15,UMB,701,215,486,701,0,ITI,ITI2,10,Umbria
2021-02-03,LOM,25577,7908,17669,1153,24424,ITC,ITC4,3,Lombardia
2021-02-26,EMR,7865,2995,4870,6819,1046,ITH,ITH5,8,Emilia-Romagna
2021-03-11,VDA,197,76,121,66,131,ITC,ITC2,2,Valle d'Aosta / Vallée d'Aoste
2021-04-09,SAR,12193,5403,6790,7842,4351,ITG,ITG2,20,Sardegna
2021-04-24,PAB,5102,2448,2654,4618,484,ITH,ITH1,4,Provincia Autonoma Bolzano / Bozen
2021-05-01,LAZ,37893,17056,20837,25955,11938,ITI,ITI4,12,Lazio
2020-12-30,MAR,17,5,12,17,0,ITI,ITI3,11,Marche
2021-03-28,LAZ,18836,7541,11295,13526,5310,ITI,ITI4,12,Lazio
2021-04-24,LIG,8169,3785,4384,5017,3152,ITC,ITC3,7,Liguria
2021-01-21,VEN,2291,719,1572,21,2270,ITH,ITH3,5,Veneto
2021-03-04,CAL,5379,3104,2275,4585,794,ITF,ITF6,18,Calabria
2021-03-05,PAB,1839,625,1214,1397,442,ITH,ITH1,4,Provincia Autonoma Bolzano / Bozen
2021-03-20,TOS,6489,2882,3607,5354,1135,ITI,ITI1,9,Toscana
2021-03-30,VEN,35864,15219,20645,30615,5249,ITH,ITH3,5,Veneto
2021-01-08,PAT,1449,313,1136,1449,0,ITH,ITH2,4,Provincia Autonoma Trento
2021-03-22,MOL,1146,439,707,903,243,ITF,ITF2,14,Molise
2021-02-22,FVG,2484,1193,1291,2067,417,ITH,ITH4,6,Friuli-Venezia Giulia
2021-03-05,SAR,5034,2444,2590,2681,2353,ITG,ITG2,20,Sardegna
2021-01-31,CAL,1107,555,552,154,953,ITF,ITF6,18,Calabria
2021-02-20,MAR,4121,1705,2416,4010,111,ITI,ITI3,11,Marche
2021-01-05,BAS,946,409,537,946,0,ITF,ITF5,17,Basilicata
2021-01-20,BAS,84,22,62,84,0,ITF,ITF5,17,Basilicata
2021-02-05,MOL,593,269,324,55,538,ITF,ITF2,14,Molise
2021-04-11,PAT,2336,1134,1202,2245,91,ITH,ITH2,4,Provincia Autonoma Trento
2021-04-13,CAM,26600,12680,13920,21071,5529,ITF,ITF3,15,Campania
2021-01-04,ABR,1401,575,826,1401,0,ITF,ITF1,13,Abruzzo
2021-03-01,PAT,1237,454,783,942,295,ITH,ITH2,4,Provincia Autonoma Trento
2021-04-28,MAR,10732,4890,5842,6002,4730,ITI,ITI3,11,Marche
2021-05-17,FVG,8519,3956,4563,6262,2257,ITH,ITH4,6,Friuli-Venezia Giulia
2021-01-27,BAS,411,175,236,113,298,ITF,ITF5,17,Basilicata
2021-03-11,ABR,5420,2184,3236,4281,1139,ITF,ITF1,13,Abruzzo
2021-03-21,EMR,11916,5270,6646,7312,4604,ITH,ITH5,8,Emilia-Romagna
2021-05-20,UMB,9739,4545,5194,6106,3633,ITI,ITI2,10,Umbria
2021-03-28,CAL,2532,1172,1360,1401,1131,ITF,ITF6,18,Calabria
2021-04-09,MAR,9558,4189,5369,9357,201,ITI,ITI3,11,Marche
2021-04-18,LIG,2584,1151,1433,2115,469,ITC,ITC3,7,Liguria
2021-04-26,MAR,8980,3983,4997,5958,3022,ITI,ITI3,11,Marche
2021-04-20,PIE,25438,11650,13788,19104,6334,ITC,ITC1,1,Piemonte
2021-01-03,LOM,854,316,538,854,0,ITC,ITC4,3,Lombardia
2021-02-20,CAM,8573,3080,5493,8270,303,ITF,ITF3,15,Campania
2021-04-01,SIC,14399,6674,7725,9684,4715,ITG,ITG1,19,Sicilia
2021-05-21,BAS,4586,2325,2261,1504,3082,ITF,ITF5,17,Basilicata
2021-02-24,TOS,10372,4467,5905,10171,201,ITI,ITI1,9,Toscana
2021-04-30,PAT,4902,2395,2507,4765,137,ITH,ITH2,4,Provincia Autonoma Trento
2021-01-13,EMR,9071,2940,6131,9071,0,ITH,ITH5,8,Emilia-Romagna
2021-02-28,FVG,2684,1002,1682,2291,393,ITH,ITH4,6,Friuli-Venezia Giulia
2021-03-10,VDA,438,183,255,225,213,ITC,ITC2,2,Valle d'Aosta / Vallée d'Aoste
2021-04-10,MOL,2562,1234,1328,2411,151,ITF,ITF2,14,Molise
2021-05-19,CAL,18416,9122,9294,11413,7003,ITF,ITF6,18,Calabria
2021-02-07,LAZ,4942,2023,2919,387,4555,ITI,ITI4,12,Lazio
2021-05-09,PIE,26985,12856,14129,13379,13606,ITC,ITC1,1,Piemonte
2021-01-03,VEN,5157,1562,3595,5157,0,ITH,ITH3,5,Veneto
2021-02-09,PAT,914,287,627,441,473,ITH,ITH2,4,Provincia Autonoma Trento
2021-02-15,SIC,3927,1818,2109,3362,565,ITG,ITG1,19,Sicilia
2021-03-09,BAS,1392,707,685,788,604,ITF,ITF5,17,Basilicata
2021-02-10,CAM,6904,3413,3491,6728,176,ITF,ITF3,15,Campania
2021-05-06,FVG,11787,5481,6306,7847,3940,ITH,ITH4,6,Friuli-Venezia Giulia
2021-05-22,VDA,938,494,444,540,398,ITC,ITC2,2,Valle d'Aosta / Vallée d'Aoste
2020-12-31,PUG,1634,782,852,1634,0,ITF,ITF4,16,Puglia
2021-01-04,LOM,6077,2097,3980,6077,0,ITC,ITC4,3,Lombardia
2021-01-20,PIE,6615,2089,4526,5898,717,ITC,ITC1,1,Piemonte
2021-02-03,VEN,5938,1664,4274,481,5457,ITH,ITH3,5,Veneto
2021-02-12,CAL,1708,667,1041,943,765,ITF,ITF6,18,Calabria
2021-03-11,PIE,13759,5069,8690,10664,3095,ITC,ITC1,1,Piemonte
2021-01-11,SAR,1183,505,678,1183,0,ITG,ITG2,20,Sardegna
2021-02-19,SIC,5128,2731,2397,4563,565,ITG,ITG1,19,Sicilia
2021-03-20,MAR,4135,1740,2395,1049,3086,ITI,ITI3,11,Marche
2021-05-06,LIG,14444,6398,8046,6144,8300,ITC,ITC3,7,Liguria
2021-05-06,PAB,5181,2747,2434,2612,2569,ITH,ITH1,4,Provincia Autonoma Bolzano / Bozen
2021-05-16,SAR,8154,3805,4349,5995,2159,ITG,ITG2,20,Sardegna
2021-01-18,PUG,1845,770,1075,1496,349,ITF,ITF4,16,Puglia
2021-02-06,EMR,7599,2405,5194,2130,5469,ITH,ITH5,8,Emilia-Romagna
2021-03-16,MOL,614,230,384,267,347,ITF,ITF2,14,Molise
2021-04-28,CAL,12456,6021,6435,9664,2792,ITF,ITF6,18,Calabria
2021-05-08,CAL,18135,8266,9869,10448,7687,ITF,ITF6,18,Calabria
2021-01-28,LOM,12194,3693,8501,780,11414,ITC,ITC4,3,Lombardia
2021-02-17,TOS,8175,3169,5006,7423,752,ITI,ITI1,9,Toscana
2021-05-18,LOM,87715,41931,45784,32442,55273,ITC,ITC4,3,Lombardia
2021-01-06,PUG,3945,1668,2277,3945,0,ITF,ITF4,16,Puglia
2021-01-25,SAR,588,212,376,22,566,ITG,ITG2,20,Sardegna
2021-02-20,VDA,251,210,41,241,10,ITC,ITC2,2,Valle d'Aosta / Vallée d'Aoste
2021-02-25,FVG,3160,1651,1509,3135,25,ITH,ITH4,6,Friuli-Venezia Giulia
2021-03-23,BAS,1586,610,976,1409,177,ITF,ITF5,17,Basilicata
2021-01-09,UMB,1745,499,1246,1745,0,ITI,ITI2,10,Umbria
2021-03-14,CAM,8502,3721,4781,4363,4139,ITF,ITF3,15,Campania
2021-04-18,PAB,3110,1607,1503,2100,1010,ITH,ITH1,4,Provincia Autonoma Bolzano / Bozen
2021-02-08,LAZ,9739,4153,5586,4508,5231,ITI,ITI4,12,Lazio
2021-01-02,BAS,949,380,569,949,0,ITF,ITF5,17,Basilicata
2021-02-18,SIC,5473,3152,2321,5045,428,ITG,ITG1,19,Sicilia
2021-04-22,PAT,3132,1461,1671,3088,44,ITH,ITH2,4,Provincia Autonoma Trento
2021-03-27,SIC,15750,7436,8314,10837,4913,ITG,ITG1,19,Sicilia
2021-04-23,EMR,29519,13794,15725,14669,14850,ITH,ITH5,8,Emilia-Romagna
2021-03-06,PAT,775,277,498,624,151,ITH,ITH2,4,Provincia Autonoma Trento
2021-04-09,TOS,24521,10539,13982,21116,3405,ITI,ITI1,9,Toscana
2021-04-12,SAR,6990,3179,3811,5276,1714,ITG,ITG2,20,Sardegna
2021-05-21,PIE,33619,15433,18186,18455,15164,ITC,ITC1,1,Piemonte
2021-01-05,PIE,5381,1603,3778,5381,0,ITC,ITC1,1,Piemonte
2021-02-24,MAR,3486,1515,1971,3408,78,ITI,ITI3,11,Marche
2021-04-08,VDA,584,282,302,441,143,ITC,ITC2,2,Valle d'Aosta / Vallée d'Aoste
2021-05-03,CAM,40733,19877,20856,28889,11844,ITF,ITF3,15,Campania
2021-05-10,PIE,28464,13659,14805,15471,12993,ITC,ITC1,1,Piemonte
2021-01-09,LAZ,6294,2561,3733,6294,0,ITI,ITI4,12,Lazio
2020-12-31,PAT,1624,449,1175,1624,0,ITH,ITH2,4,Provincia Autonoma Trento
2021-01-30,VEN,8745,2672,6073,693,8052,ITH,ITH3,5,Veneto
2021-02-14,CAM,3928,1923,2005,3894,34,ITF,ITF3,15,Campania
2021-02-23,TOS,7721,3324,4397,7560,161,ITI,ITI1,9,Toscana
2021-03-21,PAB,768,285,483,14,754,ITH,ITH1,4,Provincia Autonoma Bolzano / Bozen
2021-01-11,VDA,325,112,213,325,0,ITC,ITC2,2,Valle d'Aosta / Vallée d'Aoste
2021-03-02,VDA,339,166,173,336,3,ITC,ITC2,2,Valle d'Aosta / Vallée d'Aoste
2021-04-02,PIE,20129,8298,11831,11702,8427,ITC,ITC1,1,Piemonte
2021-05-04,VEN,42603,20178,22425,34634,7969,ITH,ITH3,5,Veneto
2021-05-20,PAB,4601,2243,2358,3197,1404,ITH,ITH1,4,Provincia Autonoma Bolzano / Bozen
2021-01-17,MAR,1606,687,919,1550,56,ITI,ITI3,11,Marche
2021-03-29,LAZ,23939,10750,13189,16908,7031,ITI,ITI4,12,Lazio
2021-05-06,UMB,9433,4301,5132,6135,3298,ITI,ITI2,10,Umbria
2021-01-14,UMB,752,201,551,752,0,ITI,ITI2,10,Umbria
2021-01-18,PAT,643,154,489,588,55,ITH,ITH2,4,Provincia Autonoma Trento
2021-01-20,VDA,23,8,15,23,0,ITC,ITC2,2,Valle d'Aosta / Vallée d'Aoste
2021-04-15,CAL,7384,3625,3759,5784,1600,ITF,ITF6,18,Calabria
2021-01-20,ABR,447,156,291,445,2,ITF,ITF1,13,Abruzzo
2021-05-04,SIC,26814,12460,14354,17627,9187,ITG,ITG1,19,Sicilia
2021-01-13,PAB,1691,557,1134,1691,0,ITH,ITH1,4,Provincia Autonoma Bolzano / Bozen
2021-01-31,LIG,624,270,354,9,615,ITC,ITC3,7,Liguria
2021-04-16,EMR,28771,13542,15229,19960,8811,ITH,ITH5,8,Emilia-Romagna
2021-04-18,UMB,1530,680,850,600,930,ITI,ITI2,10,Umbria
2021-05-10,BAS,4778,2369,2409,2739,2039,ITF,ITF5,17,Basilicata
2021-03-05,UMB,4591,1379,3212,3935,656,ITI,ITI2,10,Umbria
2021-04-11,SAR,5393,2442,2951,4273,1120,ITG,ITG2,20,Sardegna
2021-04-22,PUG,22829,10429,12400,17965,4864,ITF,ITF4,16,Puglia
2021-01-06,PAT,42,13,29,42,0,ITH,ITH2,4,Provincia Autonoma Trento
2021-02-21,FVG,800,281,519,423,377,ITH,ITH4,6,Friuli-Venezia Giulia
2021-03-08,SAR,4347,2068,2279,3127,1220,ITG,ITG2,20,Sardegna
2021-04-05,MAR,5688,2355,3333,4419,1269,ITI,ITI3,11,Marche
2021-02-13,CAL,1329,583,746,966,363,ITF,ITF6,18,Calabria
2021-02-18,CAL,1798,802,996,1573,225,ITF,ITF6,18,Calabria
2021-03-06,PUG,15926,5952,9974,13856,2070,ITF,ITF4,16,Puglia
2021-03-27,PUG,12124,5696,6428,6969,5155,ITF,ITF4,16,Puglia
2021-04-29,FVG,6656,2921,3735,4136,2520,ITH,ITH4,6,Friuli-Venezia Giulia
2021-05-18,LIG,13329,6016,7313,10043,3286,ITC,ITC3,7,Liguria
2020-12-28,LAZ,959,412,547,959,0,ITI,ITI4,12,Lazio
2021-03-29,UMB,3844,1692,2152,2365,1479,ITI,ITI2,10,Umbria
2021-01-15,SAR,1563,573,990,1563,0,ITG,ITG2,20,Sardegna
2021-02-12,SAR,2237,933,1304,2178,59,ITG,ITG2,20,Sardegna
2021-05-20,SAR,14602,6967,7635,10319,4283,ITG,ITG2,20,Sardegna
2021-04-29,LIG,15549,6974,8575,6730,8819,ITC,ITC3,7,Liguria
2021-01-18,SIC,1646,666,980,1495,151,ITG,ITG1,19,Sicilia
2021-05-05,EMR,29340,13648,15692,18120,11220,ITH,ITH5,8,Emilia-Romagna
2021-05-22,SAR,23648,11294,12354,18950,4698,ITG,ITG2,20,Sardegna
2021-01-08,PUG,5590,2345,3245,5590,0,ITF,ITF4,16,Puglia
2021-03-17,MOL,908,385,523,576,332,ITF,ITF2,14,Molise
2021-01-25,CAL,1066,513,553,148,918,ITF,ITF6,18,Calabria
2021-04-03,SIC,16363,7781,8582,13527,2836,ITG,ITG1,19,Sicilia
2021-04-30,SAR,10744,5116,5628,6684,4060,ITG,ITG2,20,Sardegna
2021-05-01,EMR,28372,12761,15611,15604,12768,ITH,ITH5,8,Emilia-Romagna
2021-02-19,CAL,1462,652,810,1201,261,ITF,ITF6,18,Calabria
2021-03-07,TOS,5647,2356,3291,2105,3542,ITI,ITI1,9,Toscana
2021-02-10,LIG,2312,837,1475,1020,1292,ITC,ITC3,7,Liguria
2021-02-21,SIC,5168,2501,2667,5062,106,ITG,ITG1,19,Sicilia
2021-03-01,PUG,15084,5858,9226,13714,1370,ITF,ITF4,16,Puglia
2021-04-17,VDA,638,407,231,636,2,ITC,ITC2,2,Valle d'Aosta / Vallée d'Aoste
2021-05-23,CAL,7386,3672,3714,3998,3388,ITF,ITF6,18,Calabria
2021-02-25,LOM,15198,6303,8895,13645,1553,ITC,ITC4,3,Lombardia
2021-05-08,ABR,10302,4876,5426,6466,3836,ITF,ITF1,13,Abruzzo
2021-02-05,EMR,9314,2966,6348,1637,7677,ITH,ITH5,8,Emilia-Romagna
2021-02-01,ABR,1632,573,1059,271,1361,ITF,ITF1,13,Abruzzo
2021-02-15,PAT,533,187,346,419,114,ITH,ITH2,4,Provincia Autonoma Trento
2021-04-12,CAL,6689,3264,3425,5091,1598,ITF,ITF6,18,Calabria
2021-04-27,CAM,32083,15582,16501,24169,7914,ITF,ITF3,15,Campania
2021-05-02,SAR,5872,2663,3209,5289,583,ITG,ITG2,20,Sardegna
2021-01-19,LOM,8125,2348,5777,7651,474,ITC,ITC4,3,Lombardia
2021-02-09,PUG,3840,1570,2270,2168,1672,ITF,ITF4,16,Puglia
2021-05-13,MAR,12601,5693,6908,7105,5496,ITI,ITI3,11,Marche
2021-03-02,MAR,4953,1941,3012,4387,566,ITI,ITI3,11,Marche
2021-01-05,LAZ,7373,2802,4571,7373,0,ITI,ITI4,12,Lazio
2021-02-14,LOM,3578,1546,2032,2944,634,ITC,ITC4,3,Lombardia
2021-04-30,PUG,34415,15379,19036,22546,11869,ITF,ITF4,16,Puglia
2021-02-27,LOM,13949,5871,8078,13307,642,ITC,ITC4,3,Lombardia
2020-12-27,BAS,106,41,65,106,0,ITF,ITF5,17,Basilicata
2021-02-02,UMB,944,274,670,32,912,ITI,ITI2,10,Umbria
2021-05-01,BAS,4699,2135,2564,3948,751,ITF,ITF5,17,Basilicata
2021-03-10,CAL,6416,3261,3155,5227,1189,ITF,ITF6,18,Calabria
2021-03-18,LOM,27425,10957,16468,16196,11229,ITC,ITC4,3,Lombardia
2021-01-11,CAL,2155,1041,1114,2155,0,ITF,ITF6,18,Calabria
2021-01-13,TOS,4062,1398,2664,4062,0,ITI,ITI1,9,Toscana
2021-03-15,UMB,4596,1930,2666,2828,1768,ITI,ITI2,10,Umbria
2021-04-20,BAS,4034,1921,2113,2203,1831,ITF,ITF5,17,Basilicata
2021-01-26,CAM,7340,3726,3614,351,6989,ITF,ITF3,15,Campania
2021-03-19,LAZ,17215,7363,9852,10888,6327,ITI,ITI4,12,Lazio
2021-04-05,ABR,2693,1147,1546,1813,880,ITF,ITF1,13,Abruzzo
2021-01-04,CAL,1051,517,534,1051,0,ITF,ITF6,18,Calabria
2021-03-07,UMB,845,180,665,838,7,ITI,ITI2,10,Umbria
2021-04-11,MAR,7117,3115,4002,6831,286,ITI,ITI3,11,Marche
2021-03-23,EMR,18693,8065,10628,12007,6686,ITH,ITH5,8,Emilia-Romagna
2021-04-20,PAT,2860,1369,1491,2824,36,ITH,ITH2,4,Provincia Autonoma Trento
2021-05-02,BAS,4182,2000,2182,3554,628,ITF,ITF5,17,Basilicata
2021-02-10,UMB,715,349,366,700,15,ITI,ITI2,10,Umbria
2021-04-07,ABR,7130,3283,3847,4405,2725,ITF,ITF1,13,Abruzzo
2021-01-14,SAR,1105,426,679,1105,0,ITG,ITG2,20,Sardegna
2021-02-06,CAM,5340,2665,2675,2102,3238,ITF,ITF3,15,Campania
2021-03-26,PAT,3153,1226,1927,2554,599,ITH,ITH2,4,Provincia Autonoma Trento
2021-04-23,CAM,32295,15504,16791,23160,9135,ITF,ITF3,15,Campania
2021-01-24,EMR,2443,885,1558,299,2144,ITH,ITH5,8,Emilia-Romagna
2021-04-02,EMR,23271,10479,12792,18814,4457,ITH,ITH5,8,Emilia-Romagna
2021-01-03,ABR,471,185,286,471,0,ITF,ITF1,13,Abruzzo
2021-01-09,MAR,1709,605,1104,1709,0,ITI,ITI3,11,Marche
2021-03-25,LOM,42566,15886,26680,30049,12517,ITC,ITC4,3,Lombardia
2021-01-23,SAR,60,22,38,0,60,ITG,ITG2,20,Sardegna
2021-02-16,TOS,9279,3339,5940,8558,721,ITI,ITI1,9,Toscana
2021-04-16,VEN,24418,10482,13936,12525,11893,ITH,ITH3,5,Veneto
2021-05-09,BAS,4675,2337,2338,2984,1691,ITF,ITF5,17,Basilicata
2021-03-15,ABR,3630,1395,2235,1822,1808,ITF,ITF1,13,Abruzzo
2021-04-30,VDA,831,355,476,485,346,ITC,ITC2,2,Valle d'Aosta / Vallée d'Aoste
2021-05-21,LIG,12523,5841,6682,9484,3039,ITC,ITC3,7,Liguria
2021-05-01,LOM,95829,43625,52204,66732,29097,ITC,ITC4,3,Lombardia
2021-01-13,UMB,450,139,311,450,0,ITI,ITI2,10,Umbria
2021-03-27,PAB,3047,1552,1495,1541,1506,ITH,ITH1,4,Provincia Autonoma Bolzano / Bozen
2021-03-28,MOL,1592,741,851,490,1102,ITF,ITF2,14,Molise
2021-04-07,UMB,5551,2284,3267,3545,2006,ITI,ITI2,10,Umbria
2021-04-11,VDA,479,208,271,479,0,ITC,ITC2,2,Valle d'Aosta / Vallée d'Aoste
2021-02-22,MOL,265,129,136,250,15,ITF,ITF2,14,Molise
2021-04-04,TOS,13910,6601,7309,13657,253,ITI,ITI1,9,Toscana
2021-01-10,CAM,8165,3736,4429,8165,0,ITF,ITF3,15,Campania
2021-02-13,VEN,3267,1474,1793,3247,20,ITH,ITH3,5,Veneto
2021-03-15,FVG,3765,1636,2129,1446,2319,ITH,ITH4,6,Friuli-Venezia Giulia
2021-02-12,MAR,1582,618,964,1430,152,ITI,ITI3,11,Marche
2021-04-09,PIE,25832,11382,14450,21324,4508,ITC,ITC1,1,Piemonte
2021-05-08,MOL,2969,1451,1518,1725,1244,ITF,ITF2,14,Molise
2021-04-27,FVG,8065,3698,4367,3607,4458,ITH,ITH4,6,Friuli-Venezia Giulia
2021-05-19,MOL,2335,1205,1130,1912,423,ITF,ITF2,14,Molise
2021-05-22,PIE,32960,14880,18080,16981,15979,ITC,ITC1,1,Piemonte
2021-03-30,LOM,39457,15468,23989,24704,14753,ITC,ITC4,3,Lombardia
2021-04-14,UMB,8147,3673,4474,6168,1979,ITI,ITI2,10,Umbria
2021-05-03,LOM,83626,39724,43902,71513,12113,ITC,ITC4,3,Lombardia
2021-02-03,ABR,2061,717,1344,419,1642,ITF,ITF1,13,Abruzzo
2021-04-18,LAZ,23771,10556,13215,16137,7634,ITI,ITI4,12,Lazio
2021-02-12,SIC,4674,1847,2827,4407,267,ITG,ITG1,19,Sicilia
2021-02-07,LOM,7305,2819,4486,340,6965,ITC,ITC4,3,Lombardia
2021-02-09,VDA,251,84,167,68,183,ITC,ITC2,2,Valle d'Aosta / Vallée d'Aoste
2021-04-03,FVG,3983,1969,2014,2655,1328,ITH,ITH4,6,Friuli-Venezia Giulia
2020-12-31,FVG,1053,384,669,1053,0,ITH,ITH4,6,Friuli-Venezia Giulia
2021-01-27,SIC,7525,3836,3689,187,7338,ITG,ITG1,19,Sicilia
2021-02-17,VDA,327,144,183,227,100,ITC,ITC2,2,Valle d'Aosta / Vallée d'Aoste
2021-04-13,ABR,5880,2753,3127,4680,1200,ITF,ITF1,13,Abruzzo
2021-05-15,SIC,56971,26611,30360,41613,15358,ITG,ITG1,19,Sicilia
2021-05-22,BAS,5431,2700,2731,1910,3521,ITF,ITF5,17,Basilicata
2021-02-27,LAZ,11424,4267,7157,10469,955,ITI,ITI4,12,Lazio
2021-03-06,VDA,22,4,18,22,0,ITC,ITC2,2,Valle d'Aosta / Vallée d'Aoste
2021-01-05,PAT,709,232,477,709,0,ITH,ITH2,4,Provincia Autonoma Trento
2021-01-24,VEN,4117,1219,2898,28,4089,ITH,ITH3,5,Veneto
2021-02-02,CAL,2287,1114,1173,177,2110,ITF,ITF6,18,Calabria
2021-03-02,CAL,4126,2385,1741,3417,709,ITF,ITF6,18,Calabria
2021-03-04,EMR,16419,5343,11076,13414,3005,ITH,ITH5,8,Emilia-Romagna
2021-05-01,VEN,38699,18173,20526,29776,8923,ITH,ITH3,5,Veneto
2021-04-26,MOL,1154,519,635,825,329,ITF,ITF2,14,Molise
2021-05-20,LAZ,49664,23687,25977,36593,13071,ITI,ITI4,12,Lazio
2021-01-09,TOS,4485,1596,2889,4485,0,ITI,ITI1,9,Toscana
2021-01-12,SAR,865,408,457,865,0,ITG,ITG2,20,Sardegna
2021-03-01,TOS,4472,1733,2739,832,3640,ITI,ITI1,9,Toscana
2021-03-13,UMB,1731,524,1207,1486,245,ITI,ITI2,10,Umbria
2021-01-28,ABR,1433,495,938,12,1421,ITF,ITF1,13,Abruzzo
2021-01-31,PUG,1811,826,985,73,1738,ITF,ITF4,16,Puglia
2021-04-02,SIC,14006,6594,7412,9220,4786,ITG,ITG1,19,Sicilia
2021-04-09,ABR,8912,4192,4720,6275,2637,ITF,ITF1,13,Abruzzo
2021-02-01,MOL,562,201,361,14,548,ITF,ITF2,14,Molise
2021-02-08,MOL,334,141,193,216,118,ITF,ITF2,14,Molise
2021-03-22,EMR,17452,7645,9807,10589,6863,ITH,ITH5,8,Emilia-Romagna
2021-03-28,MAR,4126,1739,2387,2435,1691,ITI,ITI3,11,Marche
2021-01-04,FVG,1507,558,949,1507,0,ITH,ITH4,6,Friuli-Venezia Giulia
2021-01-15,BAS,813,350,463,813,0,ITF,ITF5,17,Basilicata
2021-04-18,TOS,8323,4079,4244,7328,995,ITI,ITI1,9,Toscana
2021-04-20,CAM,31982,15484,16498,20678,11304,ITF,ITF3,15,Campania
2021-03-21,LAZ,17856,6825,11031,12806,5050,ITI,ITI4,12,Lazio
2021-04-04,PUG,5939,2953,2986,5933,6,ITF,ITF4,16,Puglia
2021-04-10,EMR,20846,9261,11585,16717,4129,ITH,ITH5,8,Emilia-Romagna
2021-04-21,VDA,868,410,458,620,248,ITC,ITC2,2,Valle d'Aosta / Vallée d'Aoste
2021-05-05,CAM,51067,24815,26252,44691,6376,ITF,ITF3,15,Campania
2021-05-20,TOS,28218,13099,15119,17983,10235,ITI,ITI1,9,Toscana
2021-03-24,EMR,21051,9291,11760,13680,7371,ITH,ITH5,8,Emilia-Romagna
2021-01-18,UMB,614,219,395,529,85,ITI,ITI2,10,Umbria
2021-02-26,VDA,207,58,149,122,85,ITC,ITC2,2,Valle d'Aosta / Vallée d'Aoste
2021-03-30,PAB,1298,532,766,218,1080,ITH,ITH1,4,Provincia Autonoma Bolzano / Bozen
2021-04-11,SIC,15344,7578,7766,8315,7029,ITG,ITG1,19,Sicilia
2021-04-13,LOM,47570,21235,26335,33507,14063,ITC,ITC4,3,Lombardia
2021-04-21,MAR,10786,4968,5818,9589,1197,ITI,ITI3,11,Marche
2021-01-15,PIE,8970,2955,6015,8970,0,ITC,ITC1,1,Piemonte
2021-01-21,LIG,1103,385,718,672,431,ITC,ITC3,7,Liguria
2021-02-24,SIC,9561,4850,4711,8971,590,ITG,ITG1,19,Sicilia
2021-03-22,VEN,18088,8132,9956,13045,5043,ITH,ITH3,5,Veneto
2021-02-05,CAM,7260,3463,3797,2133,5127,ITF,ITF3,15,Campania
2021-05-07,MAR,12836,5804,7032,3659,9177,ITI,ITI3,11,Marche
2021-01-25,MAR,1595,558,1037,97,1498,ITI,ITI3,11,Marche
2021-04-06,LAZ,23874,10652,13222,16773,7101,ITI,ITI4,12,Lazio
2021-05-10,VDA,780,381,399,546,234,ITC,ITC2,2,Valle d'Aosta / Vallée d'Aoste
2021-02-07,FVG,1561,483,1078,386,1175,ITH,ITH4,6,Friuli-Venezia Giulia
2021-03-23,VEN,22146,10186,11960,17427,4719,ITH,ITH3,5,Veneto
2021-05-09,CAM,43168,20276,22892,32081,11087,ITF,ITF3,15,Campania
2021-04-12,MAR,8568,3772,4796,8084,484,ITI,ITI3,11,Marche
2021-01-26,LOM,8375,2720,5655,372,8003,ITC,ITC4,3,Lombardia
2021-02-06,VEN,4093,1353,2740,709,3384,ITH,ITH3,5,Veneto
2021-01-07,MAR,1806,636,1170,1806,0,ITI,ITI3,11,Marche
2021-03-07,SAR,1657,750,907,1117,540,ITG,ITG2,20,Sardegna
2021-04-05,FVG,2868,1425,1443,2853,15,ITH,ITH4,6,Friuli-Venezia Giulia
2021-05-13,MOL,3025,1406,1619,2579,446,ITF,ITF2,14,Molise
2021-01-05,CAM,7238,3637,3601,7238,0,ITF,ITF3,15,Campania
2021-01-19,ABR,111,55,56,91,20,ITF,ITF1,13,Abruzzo
2021-03-05,LAZ,18777,7955,10822,14045,4732,ITI,ITI4,12,Lazio
2021-03-15,CAL,3493,1664,1829,2065,1428,ITF,ITF6,18,Calabria
2021-03-19,MAR,3835,1597,2238,339,3496,ITI,ITI3,11,Marche
2021-04-25,CAM,30696,15163,15533,25307,5389,ITF,ITF3,15,Campania
2021-03-07,PAB,114,13,101,9,105,ITH,ITH1,4,Provincia Autonoma Bolzano / Bozen
2021-04-23,PAT,3584,1743,1841,3530,54,ITH,ITH2,4,Provincia Autonoma Trento
2021-02-25,PIE,12218,5252,6966,11671,547,ITC,ITC1,1,Piemonte
2021-03-24,VEN,22020,9504,12516,15212,6808,ITH,ITH3,5,Veneto
2021-04-07,PIE,23604,9993,13611,18140,5464,ITC,ITC1,1,Piemonte
2021-04-07,SAR,14686,6496,8190,8317,6369,ITG,ITG2,20,Sardegna
2021-02-23,VDA,216,123,93,216,0,ITC,ITC2,2,Valle d'Aosta / Vallée d'Aoste
2021-04-08,BAS,763,348,415,754,9,ITF,ITF5,17,Basilicata
2021-01-14,CAL,2558,1215,1343,2558,0,ITF,ITF6,18,Calabria
2021-02-13,SIC,3097,1164,1933,2841,256,ITG,ITG1,19,Sicilia
2021-03-11,BAS,1784,920,864,825,959,ITF,ITF5,17,Basilicata
2021-04-19,BAS,4161,1910,2251,2524,1637,ITF,ITF5,17,Basilicata
2021-05-10,SIC,28304,13596,14708,16189,12115,ITG,ITG1,19,Sicilia
2021-04-10,VEN,27417,11957,15460,18936,8481,ITH,ITH3,5,Veneto
2020-12-30,FVG,626,244,382,626,0,ITH,ITH4,6,Friuli-Venezia Giulia
2021-02-28,PUG,6016,1799,4217,5830,186,ITF,ITF4,16,Puglia
2021-03-09,SIC,13156,5589,7567,10784,2372,ITG,ITG1,19,Sicilia
2021-04-12,SIC,18950,9203,9747,11610,7340,ITG,ITG1,19,Sicilia
2021-02-13,EMR,3625,1085,2540,3027,598,ITH,ITH5,8,Emilia-Romagna
2021-03-02,SAR,2865,1459,1406,1712,1153,ITG,ITG2,20,Sardegna
2021-01-17,MOL,78,38,40,48,30,ITF,ITF2,14,Molise
2021-03-26,PUG,11460,5347,6113,6816,4644,ITF,ITF4,16,Puglia
2021-01-28,PIE,5590,1809,3781,384,5206,ITC,ITC1,1,Piemonte
2021-04-14,SAR,8233,3893,4340,6996,1237,ITG,ITG2,20,Sardegna
2021-04-19,MOL,1825,842,983,1048,777,ITF,ITF2,14,Molise
2021-05-23,MOL,1155,581,574,1154,1,ITF,ITF2,14,Molise
2020-12-28,LOM,107,47,60,107,0,ITC,ITC4,3,Lombardia
2021-05-10,MAR,9448,4336,5112,4895,4553,ITI,ITI3,11,Marche
2021-01-25,SIC,7509,3695,3814,314,7195,ITG,ITG1,19,Sicilia
2021-01-07,TOS,6018,1751,4267,6018,0,ITI,ITI1,9,Toscana
2021-01-11,PIE,8742,2980,5762,8742,0,ITC,ITC1,1,Piemonte
2021-03-31,TOS,32565,13127,19438,20409,12156,ITI,ITI1,9,Toscana
2021-05-02,PIE,25034,11255,13779,14290,10744,ITC,ITC1,1,Piemonte
2021-03-07,LOM,12019,5347,6672,9460,2559,ITC,ITC4,3,Lombardia
2021-03-19,MOL,1184,482,702,757,427,ITF,ITF2,14,Molise
2021-05-05,PAT,4970,2574,2396,4689,281,ITH,ITH2,4,Provincia Autonoma Trento
2021-03-17,VDA,433,185,248,273,160,ITC,ITC2,2,Valle d'Aosta / Vallée d'Aoste
2021-03-20,SIC,18815,9031,9784,13489,5326,ITG,ITG1,19,Sicilia
2021-04-02,VEN,23965,10548,13417,17634,6331,ITH,ITH3,5,Veneto
2021-04-09,CAL,7781,3651,4130,4858,2923,ITF,ITF6,18,Calabria
2021-01-30,CAM,10721,5079,5642,38,10683,ITF,ITF3,15,Campania
2021-02-11,SAR,1315,490,825,1204,111,ITG,ITG2,20,Sardegna
2021-05-04,LIG,13598,6081,7517,5371,8227,ITC,ITC3,7,Liguria
2021-01-11,BAS,183,66,117,183,0,ITF,ITF5,17,Basilicata
2021-02-06,PAT,574,298,276,433,141,ITH,ITH2,4,Provincia Autonoma Trento
2021-01-18,PAB,1772,687,1085,1767,5,ITH,ITH1,4,Provincia Autonoma Bolzano / Bozen
2021-01-28,BAS,903,401,502,119,784,ITF,ITF5,17,Basilicata
2021-02-02,PIE,10239,3508,6731,815,9424,ITC,ITC1,1,Piemonte
2021-02-04,LAZ,6299,2478,3821,987,5312,ITI,ITI4,12,Lazio
2021-01-22,LAZ,4002,1633,2369,487,3515,ITI,ITI4,12,Lazio
2021-04-14,PAB,3593,1645,1948,3501,92,ITH,ITH1,4,Provincia Autonoma Bolzano / Bozen
2021-01-19,FVG,6,2,4,6,0,ITH,ITH4,6,Friuli-Venezia Giulia
2021-02-15,UMB,1368,692,676,1367,1,ITI,ITI2,10,Umbria
2021-02-20,LIG,1336,637,699,1335,1,ITC,ITC3,7,Liguria
2021-04-05,CAL,3450,1629,1821,2553,897,ITF,ITF6,18,Calabria
2021-01-03,FVG,312,122,190,312,0,ITH,ITH4,6,Friuli-Venezia Giulia
2021-01-17,LOM,8342,3343,4999,8141,201,ITC,ITC4,3,Lombardia
2021-03-07,PIE,11969,4656,7313,11091,878,ITC,ITC1,1,Piemonte
2021-03-30,ABR,5057,2198,2859,3233,1824,ITF,ITF1,13,Abruzzo
2021-01-11,CAM,4072,1871,2201,4072,0,ITF,ITF3,15,Campania
2021-03-04,PAB,1710,1001,709,1481,229,ITH,ITH1,4,Provincia Autonoma Bolzano / Bozen
2021-05-02,CAM,43471,21531,21940,32136,11335,ITF,ITF3,15,Campania
2021-02-05,FVG,2614,785,1829,90,2524,ITH,ITH4,6,Friuli-Venezia Giulia
2021-02-08,EMR,5227,1532,3695,2313,2914,ITH,ITH5,8,Emilia-Romagna
2021-04-24,TOS,13421,6154,7267,5987,7434,ITI,ITI1,9,Toscana
2021-01-14,PIE,9766,3152,6614,9766,0,ITC,ITC1,1,Piemonte
2021-03-04,VEN,12913,4823,8090,9446,3467,ITH,ITH3,5,Veneto
2021-03-10,LAZ,22005,9477,12528,16360,5645,ITI,ITI4,12,Lazio
2021-05-15,UMB,4963,1867,3096,1801,3162,ITI,ITI2,10,Umbria
2021-03-01,MAR,3724,1487,2237,3476,248,ITI,ITI3,11,Marche
2021-04-14,BAS,2041,997,1044,1367,674,ITF,ITF5,17,Basilicata
2021-01-23,PIE,4257,1325,2932,879,3378,ITC,ITC1,1,Piemonte
2021-02-15,CAL,1136,538,598,988,148,ITF,ITF6,18,Calabria
2021-04-24,LAZ,33269,14967,18302,20523,12746,ITI,ITI4,12,Lazio
2021-01-20,PUG,1546,541,1005,1538,8,ITF,ITF4,16,Puglia
2021-02-04,MAR,2341,809,1532,112,2229,ITI,ITI3,11,Marche
2021-02-08,SIC,4086,1760,2326,2129,1957,ITG,ITG1,19,Sicilia
2021-03-02,BAS,803,389,414,658,145,ITF,ITF5,17,Basilicata
2021-04-15,MOL,1899,779,1120,1061,838,ITF,ITF2,14,Molise
2021-03-11,PAT,2293,851,1442,1471,822,ITH,ITH2,4,Provincia Autonoma Trento
2021-03-25,SAR,8792,3702,5090,7488,1304,ITG,ITG2,20,Sardegna
2021-04-05,PUG,12682,6163,6519,12148,534,ITF,ITF4,16,Puglia
2021-01-14,BAS,969,413,556,969,0,ITF,ITF5,17,Basilicata
2021-01-18,BAS,463,157,306,364,99,ITF,ITF5,17,Basilicata
2021-02-22,PAB,526,143,383,514,12,ITH,ITH1,4,Provincia Autonoma Bolzano / Bozen
2021-04-19,VEN,21536,8920,12616,5119,16417,ITH,ITH3,5,Veneto
2021-05-06,VEN,46325,21730,24595,37930,8395,ITH,ITH3,5,Veneto
2021-05-13,PAB,2980,1347,1633,1050,1930,ITH,ITH1,4,Provincia Autonoma Bolzano / Bozen
2021-05-17,TOS,29387,14582,14805,20749,8638,ITI,ITI1,9,Toscana
2021-01-07,SIC,9180,4244,4936,9180,0,ITG,ITG1,19,Sicilia
2021-01-24,LOM,1201,459,742,537,664,ITC,ITC4,3,Lombardia
2021-01-02,PUG,2948,1300,1648,2948,0,ITF,ITF4,16,Puglia
2021-02-10,SAR,1959,765,1194,1441,518,ITG,ITG2,20,Sardegna
2021-03-01,VDA,181,66,115,147,34,ITC,ITC2,2,Valle d'Aosta / Vallée d'Aoste
2021-04-23,CAL,12611,6264,6347,9368,3243,ITF,ITF6,18,Calabria
2021-03-25,PIE,17062,7203,9859,8423,8639,ITC,ITC1,1,Piemonte
2021-03-30,FVG,7092,3142,3950,6170,922,ITH,ITH4,6,Friuli-Venezia Giulia
2021-04-02,PAB,2077,837,1240,720,1357,ITH,ITH1,4,Provincia Autonoma Bolzano / Bozen
2021-01-11,PUG,3753,1589,2164,3753,0,ITF,ITF4,16,Puglia
2021-02-21,PUG,2176,472,1704,2115,61,ITF,ITF4,16,Puglia
2021-03-04,LOM,29415,12148,17267,20286,9129,ITC,ITC4,3,Lombardia
2021-03-07,BAS,882,308,574,844,38,ITF,ITF5,17,Basilicata
2021-05-20,MAR,12374,5819,6555,7672,4702,ITI,ITI3,11,Marche
2021-05-23,LOM,45390,21505,23885,17501,27889,ITC,ITC4,3,Lombardia
2021-05-23,VEN,26350,12548,13802,7431,18919,ITH,ITH3,5,Veneto
2021-01-29,MOL,421,136,285,6,415,ITF,ITF2,14,Molise
2021-03-27,SAR,5712,2174,3538,5290,422,ITG,ITG2,20,Sardegna
2021-04-22,VDA,1067,449,618,684,383,ITC,ITC2,2,Valle d'Aosta / Vallée d'Aoste
2021-02-18,LAZ,10024,4978,5046,9215,809,ITI,ITI4,12,Lazio
2021-01-16,TOS,3271,1046,2225,3271,0,ITI,ITI1,9,Toscana
2021-02-03,CAL,2763,1428,1335,581,2182,ITF,ITF6,18,Calabria
2021-02-11,BAS,951,401,550,868,83,ITF,ITF5,17,Basilicata
2021-05-07,SIC,36626,17295,19331,24998,11628,ITG,ITG1,19,Sicilia
2021-01-01,VEN,1528,471,1057,1528,0,ITH,ITH3,5,Veneto
2021-04-11,LIG,4249,1931,2318,4000,249,ITC,ITC3,7,Liguria
2021-04-27,VDA,977,423,554,685,292,ITC,ITC2,2,Valle d'Aosta / Vallée d'Aoste
2021-01-16,PUG,2507,1033,1474,2507,0,ITF,ITF4,16,Puglia
2021-02-22,EMR,7481,3091,4390,7206,275,ITH,ITH5,8,Emilia-Romagna
2021-02-28,TOS,1649,667,982,922,727,ITI,ITI1,9,Toscana
2021-03-25,ABR,5686,2561,3125,3070,2616,ITF,ITF1,13,Abruzzo
2021-05-16,MOL,1246,570,676,1064,182,ITF,ITF2,14,Molise
2021-04-25,MAR,8599,3993,4606,7024,1575,ITI,ITI3,11,Marche
2021-01-27,UMB,840,330,510,13,827,ITI,ITI2,10,Umbria
2021-03-27,ABR,6121,2620,3501,3636,2485,ITF,ITF1,13,Abruzzo
2021-02-02,PUG,4342,1845,2497,593,3749,ITF,ITF4,16,Puglia
2021-01-08,VDA,299,130,169,299,0,ITC,ITC2,2,Valle d'Aosta / Vallée d'Aoste
2021-02-13,LIG,1080,508,572,800,280,ITC,ITC3,7,Liguria
2021-03-08,SIC,13541,5826,7715,10733,2808,ITG,ITG1,19,Sicilia
2021-03-18,MOL,1156,476,680,692,464,ITF,ITF2,14,Molise
2021-04-29,EMR,44702,21005,23697,27167,17535,ITH,ITH5,8,Emilia-Romagna
2021-05-22,PAT,3229,1585,1644,917,2312,ITH,ITH2,4,Provincia Autonoma Trento
2021-02-09,MAR,124,42,82,46,78,ITI,ITI3,11,Marche
2021-04-30,MAR,13937,6100,7837,5397,8540,ITI,ITI3,11,Marche
2021-05-01,ABR,10746,5052,5694,5768,4978,ITF,ITF1,13,Abruzzo
2021-01-30,FVG,2273,744,1529,270,2003,ITH,ITH4,6,Friuli-Venezia Giulia
2021-04-25,VDA,848,408,440,709,139,ITC,ITC2,2,Valle d'Aosta / Vallée d'Aoste
2021-05-14,PAT,5250,2514,2736,3904,1346,ITH,ITH2,4,Provincia Autonoma Trento
2021-01-05,VDA,150,54,96,150,0,ITC,ITC2,2,Valle d'Aosta / Vallée d'Aoste
2021-02-11,PIE,6764,2107,4657,3006,3758,ITC,ITC1,1,Piemonte
2021-02-13,PAB,318,79,239,312,6,ITH,ITH1,4,Provincia Autonoma Bolzano / Bozen
2021-04-01,PAT,2892,1227,1665,1799,1093,ITH,ITH2,4,Provincia Autonoma Trento
2021-04-19,EMR,20816,9750,11066,14562,6254,ITH,ITH5,8,Emilia-Romagna
2021-04-22,SIC,27094,12805,14289,20553,6541,ITG,ITG1,19,Sicilia
2021-02-19,LAZ,10312,5198,5114,9463,849,ITI,ITI4,12,Lazio
2021-03-29,SIC,15001,7035,7966,10485,4516,ITG,ITG1,19,Sicilia
2021-05-08,EMR,31064,14532,16532,19706,11358,ITH,ITH5,8,Emilia-Romagna
2021-02-03,FVG,2647,791,1856,23,2624,ITH,ITH4,6,Friuli-Venezia Giulia
2021-04-06,MAR,8879,3693,5186,8066,813,ITI,ITI3,11,Marche
2021-05-23,PAB,3296,1753,1543,3290,6,ITH,ITH1,4,Provincia Autonoma Bolzano / Bozen
2021-01-13,CAL,2028,1022,1006,2028,0,ITF,ITF6,18,Calabria
2021-03-13,SAR,2752,1073,1679,2471,281,ITG,ITG2,20,Sardegna
2021-04-13,FVG,7362,3289,4073,5758,1604,ITH,ITH4,6,Friuli-Venezia Giulia
2021-01-12,BAS,217,88,129,217,0,ITF,ITF5,17,Basilicata
2021-02-07,CAL,858,427,431,146,712,ITF,ITF6,18,Calabria
2021-02-24,LIG,3763,1560,2203,3505,258,ITC,ITC3,7,Liguria
2021-02-24,PAB,1367,406,961,1355,12,ITH,ITH1,4,Provincia Autonoma Bolzano / Bozen
2021-03-13,CAL,6663,2944,3719,5670,993,ITF,ITF6,18,Calabria
2021-05-12,VEN,35886,17337,18549,30987,4899,ITH,ITH3,5,Veneto
2021-01-13,ABR,1253,440,813,1253,0,ITF,ITF1,13,Abruzzo
2021-02-08,VEN,4976,1541,3435,1929,3047,ITH,ITH3,5,Veneto
2021-02-16,SIC,4370,2282,2088,3905,465,ITG,ITG1,19,Sicilia
2021-04-06,TOS,22166,9770,12396,18452,3714,ITI,ITI1,9,Toscana
2021-04-07,BAS,1218,549,669,1181,37,ITF,ITF5,17,Basilicata
2021-01-10,VDA,220,71,149,220,0,ITC,ITC2,2,Valle d'Aosta / Vallée d'Aoste
2021-02-27,MAR,3356,1435,1921,3147,209,ITI,ITI3,11,Marche
2021-03-29,MOL,2033,835,1198,1547,486,ITF,ITF2,14,Molise
2021-04-02,UMB,4273,1712,2561,3516,757,ITI,ITI2,10,Umbria
2021-01-12,MOL,336,114,222,336,0,ITF,ITF2,14,Molise
2021-02-01,EMR,10318,3609,6709,362,9956,ITH,ITH5,8,Emilia-Romagna
2021-02-23,LIG,3806,1559,2247,3697,109,ITC,ITC3,7,Liguria
2021-04-23,FVG,7454,3375,4079,3598,3856,ITH,ITH4,6,Friuli-Venezia Giulia
2021-02-02,PAT,907,240,667,190,717,ITH,ITH2,4,Provincia Autonoma Trento
2021-05-12,EMR,37965,17868,20097,28386,9579,ITH,ITH5,8,Emilia-Romagna
2021-01-10,FVG,2939,918,2021,2939,0,ITH,ITH4,6,Friuli-Venezia Giulia
2021-03-03,VDA,255,118,137,186,69,ITC,ITC2,2,Valle d'Aosta / Vallée d'Aoste
2021-01-06,MAR,2181,792,1389,2181,0,ITI,ITI3,11,Marche
2021-01-13,FVG,2650,834,1816,2650,0,ITH,ITH4,6,Friuli-Venezia Giulia
2021-01-19,CAL,1108,488,620,1098,10,ITF,ITF6,18,Calabria
2021-02-04,TOS,4253,1594,2659,961,3292,ITI,ITI1,9,Toscana
2021-03-05,MOL,1219,649,570,1015,204,ITF,ITF2,14,Molise
2021-03-24,LOM,43306,15625,27681,31439,11867,ITC,ITC4,3,Lombardia
2021-05-03,FVG,7163,3262,3901,3389,3774,ITH,ITH4,6,Friuli-Venezia Giulia
2020-12-31,VDA,18,4,14,18,0,ITC,ITC2,2,Valle d'Aosta / Vallée d'Aoste
2021-01-23,CAL,400,186,214,358,42,ITF,ITF6,18,Calabria
2021-05-15,SAR,16287,7551,8736,11973,4314,ITG,ITG2,20,Sardegna
2021-01-10,CAL,929,524,405,929,0,ITF,ITF6,18,Calabria
2021-03-07,ABR,2516,628,1888,2516,0,ITF,ITF1,13,Abruzzo
2021-03-24,ABR,6387,2785,3602,4134,2253,ITF,ITF1,13,Abruzzo
2021-04-01,PUG,13480,6149,7331,7139,6341,ITF,ITF4,16,Puglia
2021-01-15,PUG,4552,1866,2686,4552,0,ITF,ITF4,16,Puglia
2021-01-23,BAS,716,302,414,33,683,ITF,ITF5,17,Basilicata
2021-02-17,LIG,2688,1181,1507,2263,425,ITC,ITC3,7,Liguria
2021-03-14,MAR,2499,1031,1468,1906,593,ITI,ITI3,11,Marche
2021-01-31,TOS,3050,1129,1921,106,2944,ITI,ITI1,9,Toscana
2021-03-20,PAB,1757,848,909,1132,625,ITH,ITH1,4,Provincia Autonoma Bolzano / Bozen
2021-04-10,LOM,52335,21685,30650,40542,11793,ITC,ITC4,3,Lombardia
2021-05-10,LIG,12110,5326,6784,5737,6373,ITC,ITC3,7,Liguria
2021-05-14,PUG,44135,20142,23993,28354,15781,ITF,ITF4,16,Puglia
2021-03-14,VDA,392,200,192,392,0,ITC,ITC2,2,Valle d'Aosta / Vallée d'Aoste
2021-03-27,UMB,4252,1512,2740,3912,340,ITI,ITI2,10,Umbria
2021-03-26,TOS,20392,9154,11238,14641,5751,ITI,ITI1,9,Toscana
2021-05-18,EMR,27564,12559,15005,17275,10289,ITH,ITH5,8,Emilia-Romagna
2021-03-06,LIG,3304,1842,1462,2599,705,ITC,ITC3,7,Liguria
2021-04-17,LAZ,32299,14174,18125,20354,11945,ITI,ITI4,12,Lazio
2021-04-26,PAB,1541,771,770,1536,5,ITH,ITH1,4,Provincia Autonoma Bolzano / Bozen
2021-05-08,VEN,41076,18601,22475,29304,11772,ITH,ITH3,5,Veneto
2021-01-06,VDA,65,33,32,65,0,ITC,ITC2,2,Valle d'Aosta / Vallée d'Aoste
2021-01-25,LIG,2725,889,1836,478,2247,ITC,ITC3,7,Liguria
2021-02-23,MAR,3267,1397,1870,3211,56,ITI,ITI3,11,Marche
2021-03-22,LOM,40302,14290,26012,29759,10543,ITC,ITC4,3,Lombardia
2021-04-29,VEN,50209,23354,26855,37016,13193,ITH,ITH3,5,Veneto
2021-01-09,SIC,7326,3424,3902,7326,0,ITG,ITG1,19,Sicilia
2021-03-25,CAL,6950,3282,3668,4435,2515,ITF,ITF6,18,Calabria
2021-04-12,LIG,12384,5475,6909,10365,2019,ITC,ITC3,7,Liguria
2021-05-15,PAB,6993,3681,3312,6698,295,ITH,ITH1,4,Provincia Autonoma Bolzano / Bozen
2021-01-30,LOM,12323,4570,7753,174,12149,ITC,ITC4,3,Lombardia
2021-02-12,PAB,730,217,513,482,248,ITH,ITH1,4,Provincia Autonoma Bolzano / Bozen
2021-03-05,MAR,6176,2858,3318,4709,1467,ITI,ITI3,11,Marche
2021-04-01,TOS,26899,11106,15793,16298,10601,ITI,ITI1,9,Toscana
2021-01-20,PAT,291,73,218,279,12,ITH,ITH2,4,Provincia Autonoma Trento
2021-02-20,SAR,2041,855,1186,1707,334,ITG,ITG2,20,Sardegna
2021-05-05,FVG,9649,4208,5441,6221,3428,ITH,ITH4,6,Friuli-Venezia Giulia
2021-05-22,CAM,67791,32423,35368,46438,21353,ITF,ITF3,15,Campania
2021-01-22,MAR,487,167,320,194,293,ITI,ITI3,11,Marche
2021-02-22,VEN,7012,3040,3972,6625,387,ITH,ITH3,5,Veneto
2021-01-27,PAB,84,28,56,1,83,ITH,ITH1,4,Provincia Autonoma Bolzano / Bozen
2021-02-12,LIG,1930,691,1239,899,1031,ITC,ITC3,7,Liguria
2021-03-03,MAR,6645,3047,3598,5765,880,ITI,ITI3,11,Marche
2021-03-09,PAB,1194,543,651,1192,2,ITH,ITH1,4,Provincia Autonoma Bolzano / Bozen
2021-03-23,LOM,42480,15387,27093,29638,12842,ITC,ITC4,3,Lombardia
2021-03-31,MAR,7374,3087,4287,4350,3024,ITI,ITI3,11,Marche
2021-01-02,PAT,502,143,359,502,0,ITH,ITH2,4,Provincia Autonoma Trento
2021-02-05,LOM,25600,7436,18164,2383,23217,ITC,ITC4,3,Lombardia
2021-02-15,SAR,958,349,609,927,31,ITG,ITG2,20,Sardegna
2021-02-26,LIG,3767,1524,2243,3439,328,ITC,ITC3,7,Liguria
2021-04-14,ABR,6503,2897,3606,4424,2079,ITF,ITF1,13,Abruzzo
2021-03-11,PUG,14371,6190,8181,11263,3108,ITF,ITF4,16,Puglia
2021-03-13,PIE,13035,4717,8318,11592,1443,ITC,ITC1,1,Piemonte
2021-05-09,LOM,69479,32797,36682,56415,13064,ITC,ITC4,3,Lombardia
2021-02-21,TOS,5105,2089,3016,4935,170,ITI,ITI1,9,Toscana
2021-03-04,UMB,4485,1853,2632,3657,828,ITI,ITI2,10,Umbria
2021-04-09,BAS,1151,350,801,1088,63,ITF,ITF5,17,Basilicata
2021-04-16,CAM,34301,16552,17749,23643,10658,ITF,ITF3,15,Campania
2021-05-23,EMR,7582,3620,3962,3782,3800,ITH,ITH5,8,Emilia-Romagna
2021-02-21,PAT,155,92,63,43,112,ITH,ITH2,4,Provincia Autonoma Trento
2021-03-31,SIC,14606,6750,7856,9578,5028,ITG,ITG1,19,Sicilia
2021-05-08,PAB,4416,2379,2037,3758,658,ITH,ITH1,4,Provincia Autonoma Bolzano / Bozen
2021-02-10,CAL,2460,1075,1385,837,1623,ITF,ITF6,18,Calabria
2021-02-13,UMB,115,28,87,112,3,ITI,ITI2,10,Umbria
2021-03-02,PIE,11193,4503,6690,10377,816,ITC,ITC1,1,Piemonte
2021-05-18,MOL,1634,872,762,979,655,ITF,ITF2,14,Molise
2021-01-11,PAT,730,221,509,730,0,ITH,ITH2,4,Provincia Autonoma Trento
2021-04-12,PAB,2105,946,1159,2098,7,ITH,ITH1,4,Provincia Autonoma Bolzano / Bozen
2021-04-23,VDA,921,443,478,538,383,ITC,ITC2,2,Valle d'Aosta / Vallée d'Aoste
2021-04-26,LOM,87912,40914,46998,68757,19155,ITC,ITC4,3,Lombardia
2021-03-20,LIG,2316,995,1321,1142,1174,ITC,ITC3,7,Liguria
2021-04-08,EMR,30671,14058,16613,25397,5274,ITH,ITH5,8,Emilia-Romagna
2021-04-30,LIG,14320,6382,7938,5751,8569,ITC,ITC3,7,Liguria
2021-05-06,EMR,35392,16360,19032,22379,13013,ITH,ITH5,8,Emilia-Romagna
2021-03-23,SAR,6153,2638,3515,5075,1078,ITG,ITG2,20,Sardegna
2021-05-20,SIC,41814,19920,21894,26318,15496,ITG,ITG1,19,Sicilia
2021-01-05,VEN,7330,2182,5148,7330,0,ITH,ITH3,5,Veneto
2021-01-30,SIC,7841,3571,4270,175,7666,ITG,ITG1,19,Sicilia
2021-02-07,MOL,66,32,34,19,47,ITF,ITF2,14,Molise
2021-02-14,LAZ,5773,2370,3403,5303,470,ITI,ITI4,12,Lazio
2021-03-03,FVG,3636,1625,2011,2363,1273,ITH,ITH4,6,Friuli-Venezia Giulia
2021-03-13,ABR,4125,1421,2704,3083,1042,ITF,ITF1,13,Abruzzo
2020-12-27,PUG,509,252,257,509,0,ITF,ITF4,16,Puglia
2021-05-12,ABR,9617,4586,5031,6046,3571,ITF,ITF1,13,Abruzzo
2021-03-30,LIG,12147,5379,6768,8758,3389,ITC,ITC3,7,Liguria
2021-01-14,SIC,5256,2517,2739,5256,0,ITG,ITG1,19,Sicilia
2021-03-12,ABR,6014,1985,4029,4432,1582,ITF,ITF1,13,Abruzzo
2021-02-16,MOL,156,70,86,150,6,ITF,ITF2,14,Molise
2021-03-20,MOL,2320,968,1352,999,1321,ITF,ITF2,14,Molise
2021-04-08,PAB,2754,1336,1418,2551,203,ITH,ITH1,4,Provincia Autonoma Bolzano / Bozen
2021-03-16,MAR,3471,1485,1986,290,3181,ITI,ITI3,11,Marche
2021-03-21,SIC,15228,7338,7890,11253,3975,ITG,ITG1,19,Sicilia
2020-12-27,SAR,65,34,31,65,0,ITG,ITG2,20,Sardegna
2021-03-02,CAM,12755,4554,8201,8410,4345,ITF,ITF3,15,Campania
2021-04-01,EMR,23860,10725,13135,19329,4531,ITH,ITH5,8,Emilia-Romagna
2021-01-06,CAL,928,501,427,928,0,ITF,ITF6,18,Calabria
2021-01-17,PIE,3518,1168,2350,2870,648,ITC,ITC1,1,Piemonte
2021-04-22,LIG,13821,6194,7627,8748,5073,ITC,ITC3,7,Liguria
2021-04-27,VEN,28077,12737,15340,21152,6925,ITH,ITH3,5,Veneto
2021-01-26,PIE,6330,1879,4451,735,5595,ITC,ITC1,1,Piemonte
2021-02-17,MOL,72,32,40,57,15,ITF,ITF2,14,Molise
2021-03-22,CAM,12738,5920,6818,10698,2040,ITF,ITF3,15,Campania
2021-03-31,CAM,22679,10905,11774,19240,3439,ITF,ITF3,15,Campania
2021-04-01,LOM,42865,17191,25674,26740,16125,ITC,ITC4,3,Lombardia
2021-04-18,PUG,22513,10763,11750,21450,1063,ITF,ITF4,16,Puglia
2021-04-20,VDA,932,430,502,738,194,ITC,ITC2,2,Valle d'Aosta / Vallée d'Aoste
2020-12-27,FVG,262,149,113,262,0,ITH,ITH4,6,Friuli-Venezia Giulia
2021-01-20,VEN,1038,368,670,386,652,ITH,ITH3,5,Veneto
2021-02-12,UMB,671,224,447,665,6,ITI,ITI2,10,Umbria
2021-03-06,FVG,3494,1195,2299,3169,325,ITH,ITH4,6,Friuli-Venezia Giulia
2021-03-10,LIG,5878,2840,3038,3972,1906,ITC,ITC3,7,Liguria
2021-01-10,TOS,3001,1104,1897,3001,0,ITI,ITI1,9,Toscana
2021-03-06,LOM,21316,9086,12230,16801,4515,ITC,ITC4,3,Lombardia
2021-04-02,ABR,6684,3093,3591,5197,1487,ITF,ITF1,13,Abruzzo
2021-01-18,LOM,9156,2968,6188,8175,981,ITC,ITC4,3,Lombardia
2021-03-12,VDA,531,175,356,305,226,ITC,ITC2,2,Valle d'Aosta / Vallée d'Aoste
2021-04-26,PIE,19713,8718,10995,15334,4379,ITC,ITC1,1,Piemonte
2021-01-05,LOM,7821,2566,5255,7821,0,ITC,ITC4,3,Lombardia
2021-04-04,ABR,1630,767,863,1501,129,ITF,ITF1,13,Abruzzo
2021-05-09,SAR,6125,2873,3252,5195,930,ITG,ITG2,20,Sardegna
2021-02-02,FVG,2467,806,1661,217,2250,ITH,ITH4,6,Friuli-Venezia Giulia
2021-03-26,ABR,5302,2261,3041,3231,2071,ITF,ITF1,13,Abruzzo
2020-12-27,PAT,103,40,63,103,0,ITH,ITH2,4,Provincia Autonoma Trento
2021-01-19,EMR,2045,505,1540,2028,17,ITH,ITH5,8,Emilia-Romagna
2021-03-08,LIG,5622,2456,3166,3933,1689,ITC,ITC3,7,Liguria
2021-01-18,EMR,3127,879,2248,2449,678,ITH,ITH5,8,Emilia-Romagna
2021-01-23,CAM,3838,2028,1810,273,3565,ITF,ITF3,15,Campania
2021-01-16,ABR,928,428,500,928,0,ITF,ITF1,13,Abruzzo
2021-01-27,VEN,7138,2062,5076,241,6897,ITH,ITH3,5,Veneto
2021-03-17,CAM,11588,5099,6489,5008,6580,ITF,ITF3,15,Campania
2021-04-28,ABR,9502,4581,4921,7482,2020,ITF,ITF1,13,Abruzzo
2021-04-28,VDA,1217,632,585,713,504,ITC,ITC2,2,Valle d'Aosta / Vallée d'Aoste
2021-01-24,SIC,4308,2252,2056,142,4166,ITG,ITG1,19,Sicilia
2021-01-26,UMB,816,390,426,18,798,ITI,ITI2,10,Umbria
2021-03-27,LIG,3921,1538,2383,2525,1396,ITC,ITC3,7,Liguria
2021-04-03,SAR,4621,1785,2836,2695,1926,ITG,ITG2,20,Sardegna
2021-04-27,CAL,9856,4854,5002,7997,1859,ITF,ITF6,18,Calabria
2021-05-06,LAZ,48571,22596,25975,31082,17489,ITI,ITI4,12,Lazio
2021-03-01,CAL,2682,1527,1155,2232,450,ITF,ITF6,18,Calabria
2021-04-02,VDA,873,344,529,648,225,ITC,ITC2,2,Valle d'Aosta / Vallée d'Aoste
2021-04-14,MAR,10215,4564,5651,9843,372,ITI,ITI3,11,Marche
2021-05-07,LIG,13563,6023,7540,5798,7765,ITC,ITC3,7,Liguria
2021-04-17,FVG,7447,3232,4215,5965,1482,ITH,ITH4,6,Friuli-Venezia Giulia
2021-04-18,PAT,1854,844,1010,1845,9,ITH,ITH2,4,Provincia Autonoma Trento
2021-04-29,LAZ,38491,17170,21321,25290,13201,ITI,ITI4,12,Lazio
2021-02-02,SAR,1482,655,827,241,1241,ITG,ITG2,20,Sardegna
2021-02-22,LOM,11894,4808,7086,11586,308,ITC,ITC4,3,Lombardia
2021-01-20,SAR,210,77,133,208,2,ITG,ITG2,20,Sardegna
2021-01-22,UMB,276,105,171,32,244,ITI,ITI2,10,Umbria
2021-02-22,MAR,3413,1499,1914,3338,75,ITI,ITI3,11,Marche
2021-03-27,CAM,21271,10030,11241,17407,3864,ITF,ITF3,15,Campania
2021-01-12,VDA,302,72,230,302,0,ITC,ITC2,2,Valle d'Aosta / Vallée d'Aoste
2021-01-15,PAT,595,132,463,595,0,ITH,ITH2,4,Provincia Autonoma Trento
2021-03-27,LOM,32311,12316,19995,23707,8604,ITC,ITC4,3,Lombardia
2021-04-04,MAR,3824,1792,2032,2655,1169,ITI,ITI3,11,Marche
2021-04-08,PIE,25138,10926,14212,20408,4730,ITC,ITC1,1,Piemonte
2021-04-22,FVG,6754,3072,3682,3078,3676,ITH,ITH4,6,Friuli-Venezia Giulia
2021-05-18,VEN,26432,12334,14098,13176,13256,ITH,ITH3,5,Veneto
2021-01-31,UMB,1058,276,782,25,1033,ITI,ITI2,10,Umbria
2021-04-10,MAR,10915,4618,6297,10602,313,ITI,ITI3,11,Marche
2021-04-17,LIG,7382,3217,4165,6632,750,ITC,ITC3,7,Liguria
2021-05-07,FVG,10519,4806,5713,7052,3467,ITH,ITH4,6,Friuli-Venezia Giulia
2021-01-05,SAR,1327,446,881,1327,0,ITG,ITG2,20,Sardegna
2021-03-31,LIG,11844,5207,6637,9074,2770,ITC,ITC3,7,Liguria
2021-01-03,UMB,270,112,158,270,0,ITI,ITI2,10,Umbria
2021-05-21,SAR,19361,9447,9914,14427,4934,ITG,ITG2,20,Sardegna
2021-02-11,MAR,1987,657,1330,1598,389,ITI,ITI3,11,Marche
2021-03-02,PAB,695,200,495,693,2,ITH,ITH1,4,Provincia Autonoma Bolzano / Bozen
2021-05-03,BAS,4514,2044,2470,3686,828,ITF,ITF5,17,Basilicata
2021-05-23,UMB,3958,1442,2516,406,3552,ITI,ITI2,10,Umbria
2021-01-20,TOS,1331,637,694,1083,248,ITI,ITI1,9,Toscana
2021-02-06,FVG,1154,338,816,22,1132,ITH,ITH4,6,Friuli-Venezia Giulia
2021-01-13,SIC,5266,2491,2775,5266,0,ITG,ITG1,19,Sicilia
2021-02-24,MOL,666,278,388,333,333,ITF,ITF2,14,Molise
2021-03-04,BAS,2006,955,1051,1084,922,ITF,ITF5,17,Basilicata
2021-02-10,PIE,7534,2371,5163,1316,6218,ITC,ITC1,1,Piemonte
2021-03-04,SIC,15189,6547,8642,10991,4198,ITG,ITG1,19,Sicilia
2021-03-05,SIC,15883,6842,9041,11563,4320,ITG,ITG1,19,Sicilia
2021-04-03,LOM,36217,14852,21365,26158,10059,ITC,ITC4,3,Lombardia
2021-01-16,LOM,15415,5723,9692,15415,0,ITC,ITC4,3,Lombardia
2021-02-23,SIC,8909,4670,4239,8446,463,ITG,ITG1,19,Sicilia
2021-03-08,UMB,3668,1799,1869,2305,1363,ITI,ITI2,10,Umbria
2021-02-14,BAS,151,48,103,151,0,ITF,ITF5,17,Basilicata
2021-04-02,MAR,6875,2973,3902,6135,740,ITI,ITI3,11,Marche
2021-04-08,LIG,13727,6157,7570,11683,2044,ITC,ITC3,7,Liguria
2021-04-17,UMB,6664,3058,3606,5324,1340,ITI,ITI2,10,Umbria
2021-05-01,FVG,7177,3240,3937,6134,1043,ITH,ITH4,6,Friuli-Venezia Giulia
2021-05-12,BAS,5917,2919,2998,3722,2195,ITF,ITF5,17,Basilicata
2021-02-17,CAL,1680,672,1008,1469,211,ITF,ITF6,18,Calabria
2021-02-17,PUG,4270,1744,2526,3669,601,ITF,ITF4,16,Puglia
2021-04-18,SAR,5155,2239,2916,2287,2868,ITG,ITG2,20,Sardegna
2021-04-18,VEN,17519,7255,10264,9946,7573,ITH,ITH3,5,Veneto
2020-12-27,VEN,880,395,485,880,0,ITH,ITH3,5,Veneto
2021-01-02,LAZ,6707,2631,4076,6707,0,ITI,ITI4,12,Lazio
2021-05-09,PAT,2322,1210,1112,1978,344,ITH,ITH2,4,Provincia Autonoma Trento
2021-01-22,FVG,90,30,60,0,90,ITH,ITH4,6,Friuli-Venezia Giulia
2021-02-22,ABR,2643,1174,1469,2613,30,ITF,ITF1,13,Abruzzo
2021-05-09,PUG,30388,12442,17946,14883,15505,ITF,ITF4,16,Puglia
2021-01-10,PAB,2,2,0,2,0,ITH,ITH1,4,Provincia Autonoma Bolzano / Bozen
2021-03-24,PAT,2375,940,1435,1555,820,ITH,ITH2,4,Provincia Autonoma Trento
2021-04-10,ABR,8772,4057,4715,6264,2508,ITF,ITF1,13,Abruzzo
2021-05-07,UMB,10081,4683,5398,6882,3199,ITI,ITI2,10,Umbria
2021-01-04,EMR,7272,2514,4758,7272,0,ITH,ITH5,8,Emilia-Romagna
2021-03-02,LIG,4074,1689,2385,3764,310,ITC,ITC3,7,Liguria
2021-03-09,LAZ,20867,8938,11929,15670,5197,ITI,ITI4,12,Lazio
2021-04-16,FVG,6910,2995,3915,4987,1923,ITH,ITH4,6,Friuli-Venezia Giulia
2021-05-06,SIC,28969,13710,15259,18405,10564,ITG,ITG1,19,Sicilia
2021-04-13,UMB,7673,3397,4276,6004,1669,ITI,ITI2,10,Umbria
2021-05-04,PAT,4473,2421,2052,4383,90,ITH,ITH2,4,Provincia Autonoma Trento
2021-02-02,VEN,6411,1847,4564,392,6019,ITH,ITH3,5,Veneto
2021-03-31,PAB,1831,693,1138,820,1011,ITH,ITH1,4,Provincia Autonoma Bolzano / Bozen
2021-04-21,PAT,2892,1348,1544,2842,50,ITH,ITH2,4,Provincia Autonoma Trento
2021-03-12,EMR,18085,7528,10557,11368,6717,ITH,ITH5,8,Emilia-Romagna
2021-04-24,PIE,27414,12406,15008,21782,5632,ITC,ITC1,1,Piemonte
2021-05-17,CAM,49213,21606,27607,24076,25137,ITF,ITF3,15,Campania
2021-05-21,VEN,42784,21029,21755,20049,22735,ITH,ITH3,5,Veneto
2021-03-14,PIE,8200,3332,4868,5308,2892,ITC,ITC1,1,Piemonte
2021-03-23,PUG,10405,4995,5410,3938,6467,ITF,ITF4,16,Puglia
2021-01-12,MAR,1226,413,813,1226,0,ITI,ITI3,11,Marche
2021-01-27,SAR,1409,494,915,79,1330,ITG,ITG2,20,Sardegna
2021-02-19,BAS,1622,737,885,1560,62,ITF,ITF5,17,Basilicata
2021-04-03,CAL,8820,3788,5032,4201,4619,ITF,ITF6,18,Calabria
2021-04-28,BAS,4705,2158,2547,4264,441,ITF,ITF5,17,Basilicata
2021-02-11,ABR,816,262,554,773,43,ITF,ITF1,13,Abruzzo
2021-01-08,BAS,554,219,335,554,0,ITF,ITF5,17,Basilicata
2021-02-20,BAS,1161,531,630,1043,118,ITF,ITF5,17,Basilicata
2021-03-26,BAS,1956,703,1253,1695,261,ITF,ITF5,17,Basilicata
2021-04-29,SIC,31657,14755,16902,22323,9334,ITG,ITG1,19,Sicilia
2021-05-07,PAB,4180,2055,2125,3662,518,ITH,ITH1,4,Provincia Autonoma Bolzano / Bozen
2021-01-09,MOL,450,152,298,450,0,ITF,ITF2,14,Molise
2021-01-14,LAZ,5455,2135,3320,5455,0,ITI,ITI4,12,Lazio
2021-03-01,LIG,3507,1430,2077,3385,122,ITC,ITC3,7,Liguria
2021-03-16,VDA,180,37,143,118,62,ITC,ITC2,2,Valle d'Aosta / Vallée d'Aoste
2021-04-18,FVG,6038,2799,3239,5631,407,ITH,ITH4,6,Friuli-Venezia Giulia
2021-02-17,PAT,1110,425,685,1020,90,ITH,ITH2,4,Provincia Autonoma Trento
2021-03-16,ABR,3484,1452,2032,1830,1654,ITF,ITF1,13,Abruzzo
2021-05-14,MOL,2641,1213,1428,1924,717,ITF,ITF2,14,Molise
2021-02-03,EMR,9350,2994,6356,983,8367,ITH,ITH5,8,Emilia-Romagna
2021-03-08,PAB,1200,526,674,1173,27,ITH,ITH1,4,Provincia Autonoma Bolzano / Bozen
2021-03-23,FVG,3753,1558,2195,1613,2140,ITH,ITH4,6,Friuli-Venezia Giulia
2021-03-24,FVG,3766,1530,2236,2286,1480,ITH,ITH4,6,Friuli-Venezia Giulia
2021-04-03,VEN,21880,9599,12281,14163,7717,ITH,ITH3,5,Veneto
2021-04-19,SIC,18474,8738,9736,12767,5707,ITG,ITG1,19,Sicilia
2021-03-01,CAM,12130,4247,7883,8017,4113,ITF,ITF3,15,Campania
2021-02-04,CAM,7944,3429,4515,1308,6636,ITF,ITF3,15,Campania
2021-03-30,UMB,3948,1705,2243,2416,1532,ITI,ITI2,10,Umbria
2021-03-17,PIE,12515,5053,7462,5224,7291,ITC,ITC1,1,Piemonte
2021-04-04,VDA,572,253,319,571,1,ITC,ITC2,2,Valle d'Aosta / Vallée d'Aoste
2021-02-04,PIE,10279,3360,6919,595,9684,ITC,ITC1,1,Piemonte
2021-03-07,MAR,5182,2108,3074,4429,753,ITI,ITI3,11,Marche
2021-01-31,PIE,4112,1752,2360,112,4000,ITC,ITC1,1,Piemonte
2021-04-21,PUG,22991,10607,12384,19260,3731,ITF,ITF4,16,Puglia
2021-04-30,LOM,116859,54622,62237,89685,27174,ITC,ITC4,3,Lombardia
2021-01-03,EMR,2754,941,1813,2754,0,ITH,ITH5,8,Emilia-Romagna
2021-01-20,UMB,613,222,391,613,0,ITI,ITI2,10,Umbria
2021-03-01,LOM,18796,8231,10565,17091,1705,ITC,ITC4,3,Lombardia
2021-03-04,LAZ,18627,7999,10628,13611,5016,ITI,ITI4,12,Lazio
2021-04-15,LOM,49359,21829,27530,35549,13810,ITC,ITC4,3,Lombardia
2021-05-02,LIG,3872,1768,2104,500,3372,ITC,ITC3,7,Liguria
2021-01-16,EMR,5626,1718,3908,5626,0,ITH,ITH5,8,Emilia-Romagna
2021-02-11,VDA,231,107,124,222,9,ITC,ITC2,2,Valle d'Aosta / Vallée d'Aoste
2021-03-23,PAT,2444,943,1501,1704,740,ITH,ITH2,4,Provincia Autonoma Trento
2021-03-24,PUG,12974,5981,6993,5718,7256,ITF,ITF4,16,Puglia
2021-05-08,PIE,33804,16040,17764,18192,15612,ITC,ITC1,1,Piemonte
2021-05-08,UMB,8096,3728,4368,4902,3194,ITI,ITI2,10,Umbria
2021-01-06,LOM,7061,2492,4569,7061,0,ITC,ITC4,3,Lombardia
2021-01-20,PAB,617,252,365,409,208,ITH,ITH1,4,Provincia Autonoma Bolzano / Bozen
2021-01-28,TOS,6282,1882,4400,354,5928,ITI,ITI1,9,Toscana
2021-03-26,VDA,498,204,294,491,7,ITC,ITC2,2,Valle d'Aosta / Vallée d'Aoste
2021-04-05,BAS,723,233,490,421,302,ITF,ITF5,17,Basilicata
2021-05-04,PUG,34572,14571,20001,18237,16335,ITF,ITF4,16,Puglia
2021-02-18,PIE,4789,2093,2696,4359,430,ITC,ITC1,1,Piemonte
2021-05-15,MAR,13967,6376,7591,8075,5892,ITI,ITI3,11,Marche
2021-01-23,UMB,280,100,180,2,278,ITI,ITI2,10,Umbria
2021-02-02,MAR,1192,397,795,73,1119,ITI,ITI3,11,Marche
2021-04-07,PAB,1777,802,975,1238,539,ITH,ITH1,4,Provincia Autonoma Bolzano / Bozen
2021-04-09,EMR,25402,11527,13875,19755,5647,ITH,ITH5,8,Emilia-Romagna
2021-05-19,CAM,51001,22486,28515,34515,16486,ITF,ITF3,15,Campania
2021-01-11,TOS,5094,1691,3403,5094,0,ITI,ITI1,9,Toscana
2021-03-22,LIG,7668,3402,4266,4732,2936,ITC,ITC3,7,Liguria
2021-04-03,MAR,7573,3204,4369,6903,670,ITI,ITI3,11,Marche
2021-02-25,SIC,10128,5255,4873,8962,1166,ITG,ITG1,19,Sicilia
2021-03-20,CAM,13880,6428,7452,10141,3739,ITF,ITF3,15,Campania
2021-05-05,UMB,7166,3280,3886,3871,3295,ITI,ITI2,10,Umbria
2021-04-15,ABR,7745,3612,4133,5906,1839,ITF,ITF1,13,Abruzzo
2021-05-21,ABR,12933,6299,6634,8000,4933,ITF,ITF1,13,Abruzzo
2020-12-30,PIE,730,322,408,730,0,ITC,ITC1,1,Piemonte
2021-02-15,CAM,5470,2516,2954,5297,173,ITF,ITF3,15,Campania
2021-04-25,BAS,2986,1458,1528,2932,54,ITF,ITF5,17,Basilicata
2021-01-04,BAS,607,271,336,607,0,ITF,ITF5,17,Basilicata
2021-04-06,PAB,2249,1117,1132,2146,103,ITH,ITH1,4,Provincia Autonoma Bolzano / Bozen
2021-04-23,LAZ,37563,18019,19544,22330,15233,ITI,ITI4,12,Lazio
2021-01-23,PAB,197,117,80,0,197,ITH,ITH1,4,Provincia Autonoma Bolzano / Bozen
2020-12-27,VDA,20,9,11,20,0,ITC,ITC2,2,Valle d'Aosta / Vallée d'Aoste
2021-01-06,ABR,1830,664,1166,1830,0,ITF,ITF1,13,Abruzzo
2021-01-31,FVG,2715,836,1879,385,2330,ITH,ITH4,6,Friuli-Venezia Giulia
2021-05-05,PAB,4153,1945,2208,2038,2115,ITH,ITH1,4,Provincia Autonoma Bolzano / Bozen
2021-01-04,LAZ,7480,2908,4572,7480,0,ITI,ITI4,12,Lazio
2021-02-08,MAR,833,258,575,371,462,ITI,ITI3,11,Marche
2021-04-08,FVG,7207,3014,4193,5287,1920,ITH,ITH4,6,Friuli-Venezia Giulia
2021-03-08,EMR,12070,4976,7094,9399,2671,ITH,ITH5,8,Emilia-Romagna
2021-05-01,MAR,9320,3925,5395,3577,5743,ITI,ITI3,11,Marche
2021-05-16,EMR,25459,11979,13480,18372,7087,ITH,ITH5,8,Emilia-Romagna
2021-01-28,SAR,2968,1044,1924,69,2899,ITG,ITG2,20,Sardegna
2021-02-07,CAM,2929,1382,1547,2158,771,ITF,ITF3,15,Campania
2021-02-09,CAM,4643,2202,2441,4391,252,ITF,ITF3,15,Campania
2021-02-27,PAB,2457,759,1698,2447,10,ITH,ITH1,4,Provincia Autonoma Bolzano / Bozen
2021-05-18,MAR,11061,5256,5805,7657,3404,ITI,ITI3,11,Marche
2021-03-17,FVG,3231,1265,1966,743,2488,ITH,ITH4,6,Friuli-Venezia Giulia
2021-01-15,EMR,7744,2403,5341,7744,0,ITH,ITH5,8,Emilia-Romagna
2021-01-15,VDA,218,82,136,218,0,ITC,ITC2,2,Valle d'Aosta / Vallée d'Aoste
2021-04-24,SAR,10366,4851,5515,8026,2340,ITG,ITG2,20,Sardegna
2021-04-25,SIC,21353,10184,11169,16377,4976,ITG,ITG1,19,Sicilia
2021-05-06,MOL,2679,1214,1465,2081,598,ITF,ITF2,14,Molise
2021-02-01,LAZ,5674,2176,3498,354,5320,ITI,ITI4,12,Lazio
2021-03-17,LIG,5553,2369,3184,2474,3079,ITC,ITC3,7,Liguria
2021-04-01,VDA,776,394,382,764,12,ITC,ITC2,2,Valle d'Aosta / Vallée d'Aoste
2021-05-23,FVG,5715,2770,2945,2666,3049,ITH,ITH4,6,Friuli-Venezia Giulia
2021-01-07,LAZ,7745,2901,4844,7745,0,ITI,ITI4,12,Lazio
2021-01-25,PAB,487,183,304,3,484,ITH,ITH1,4,Provincia Autonoma Bolzano / Bozen
2021-02-10,FVG,1352,496,856,1266,86,ITH,ITH4,6,Friuli-Venezia Giulia
2021-04-03,ABR,5083,2219,2864,3487,1596,ITF,ITF1,13,Abruzzo
2021-01-17,PAB,2328,1044,1284,2317,11,ITH,ITH1,4,Provincia Autonoma Bolzano / Bozen
2021-04-11,TOS,3640,1677,1963,3485,155,ITI,ITI1,9,Toscana
2021-04-21,VEN,32268,13162,19106,16198,16070,ITH,ITH3,5,Veneto
2021-02-01,BAS,242,91,151,46,196,ITF,ITF5,17,Basilicata
2021-01-05,MAR,1562,586,976,1562,0,ITI,ITI3,11,Marche
2021-03-19,PIE,11018,4510,6508,4414,6604,ITC,ITC1,1,Piemonte
2021-05-13,CAM,55377,24807,30570,39389,15988,ITF,ITF3,15,Campania
2021-01-10,SAR,2183,750,1433,2183,0,ITG,ITG2,20,Sardegna
2021-01-26,FVG,1977,647,1330,217,1760,ITH,ITH4,6,Friuli-Venezia Giulia
2021-04-15,EMR,28933,13776,15157,19285,9648,ITH,ITH5,8,Emilia-Romagna
2021-04-27,PUG,26450,11974,14476,20856,5594,ITF,ITF4,16,Puglia
2021-04-29,MOL,2231,1140,1091,887,1344,ITF,ITF2,14,Molise
2021-05-04,LOM,86686,41019,45667,72371,14315,ITC,ITC4,3,Lombardia
2021-01-27,MAR,2118,780,1338,122,1996,ITI,ITI3,11,Marche
2021-01-28,VEN,9209,2662,6547,173,9036,ITH,ITH3,5,Veneto
2021-02-09,LIG,1937,690,1247,257,1680,ITC,ITC3,7,Liguria
2021-03-10,FVG,3358,1493,1865,1566,1792,ITH,ITH4,6,Friuli-Venezia Giulia
2021-03-27,FVG,4984,2560,2424,3573,1411,ITH,ITH4,6,Friuli-Venezia Giulia
2021-03-30,EMR,23274,10287,12987,18241,5033,ITH,ITH5,8,Emilia-Romagna
2021-04-27,PAT,3876,1864,2012,3809,67,ITH,ITH2,4,Provincia Autonoma Trento
2021-03-03,SIC,14669,6523,8146,11581,3088,ITG,ITG1,19,Sicilia
2021-04-01,BAS,2808,1134,1674,2092,716,ITF,ITF5,17,Basilicata
2021-04-09,LOM,52192,22282,29910,36197,15995,ITC,ITC4,3,Lombardia
2021-05-02,EMR,25433,11587,13846,13449,11984,ITH,ITH5,8,Emilia-Romagna
2021-05-05,VEN,43801,21015,22786,37294,6507,ITH,ITH3,5,Veneto
2021-02-04,UMB,733,226,507,25,708,ITI,ITI2,10,Umbria
2021-03-17,SAR,6556,2849,3707,4949,1607,ITG,ITG2,20,Sardegna
2021-03-20,LOM,32512,12152,20360,22660,9852,ITC,ITC4,3,Lombardia
2021-04-08,UMB,5831,2465,3366,4036,1795,ITI,ITI2,10,Umbria
2021-05-21,VDA,917,433,484,531,386,ITC,ITC2,2,Valle d'Aosta / Vallée d'Aoste
2020-12-31,CAM,1490,811,679,1490,0,ITF,ITF3,15,Campania
2021-01-30,MOL,461,158,303,12,449,ITF,ITF2,14,Molise
2021-02-04,PAB,1958,593,1365,8,1950,ITH,ITH1,4,Provincia Autonoma Bolzano / Bozen
2021-02-21,CAL,608,286,322,531,77,ITF,ITF6,18,Calabria
2021-03-02,UMB,3642,1346,2296,3638,4,ITI,ITI2,10,Umbria
2021-04-24,FVG,6674,2946,3728,5431,1243,ITH,ITH4,6,Friuli-Venezia Giulia
2021-05-04,EMR,28531,13366,15165,14883,13648,ITH,ITH5,8,Emilia-Romagna
2021-05-09,VEN,34866,16037,18829,24811,10055,ITH,ITH3,5,Veneto
2021-05-13,LIG,13038,5850,7188,8823,4215,ITC,ITC3,7,Liguria
2021-05-20,MOL,2507,1274,1233,2376,131,ITF,ITF2,14,Molise
2021-01-04,SIC,8391,4185,4206,8391,0,ITG,ITG1,19,Sicilia
2021-01-29,EMR,10411,3497,6914,289,10122,ITH,ITH5,8,Emilia-Romagna
2021-02-01,SIC,6069,2681,3388,302,5767,ITG,ITG1,19,Sicilia
2021-03-25,MOL,1806,730,1076,1309,497,ITF,ITF2,14,Molise
2021-03-28,PIE,16040,6893,9147,8432,7608,ITC,ITC1,1,Piemonte
2021-04-07,TOS,35627,15288,20339,28381,7246,ITI,ITI1,9,Toscana
2021-04-24,VEN,24722,10816,13906,15644,9078,ITH,ITH3,5,Veneto
2021-04-08,VEN,32296,14338,17958,24421,7875,ITH,ITH3,5,Veneto
2021-04-24,PUG,29146,13261,15885,25196,3950,ITF,ITF4,16,Puglia
2021-03-11,LAZ,23773,10566,13207,17544,6229,ITI,ITI4,12,Lazio
2021-05-01,VDA,938,562,376,454,484,ITC,ITC2,2,Valle d'Aosta / Vallée d'Aoste
2021-05-11,MOL,3193,1410,1783,2954,239,ITF,ITF2,14,Molise
2021-05-16,LOM,68414,32382,36032,36456,31958,ITC,ITC4,3,Lombardia
2021-02-15,LIG,2264,839,1425,1867,397,ITC,ITC3,7,Liguria
2021-04-05,LAZ,19889,9047,10842,13670,6219,ITI,ITI4,12,Lazio
2021-05-05,SAR,9897,4518,5379,7888,2009,ITG,ITG2,20,Sardegna
2021-03-12,BAS,1898,976,922,799,1099,ITF,ITF5,17,Basilicata
2021-03-19,CAM,11036,4870,6166,7165,3871,ITF,ITF3,15,Campania
2021-05-13,PIE,35168,17174,17994,20418,14750,ITC,ITC1,1,Piemonte
2021-01-28,PAB,871,308,563,10,861,ITH,ITH1,4,Provincia Autonoma Bolzano / Bozen
2021-03-14,PUG,3317,1429,1888,2506,811,ITF,ITF4,16,Puglia
2021-03-28,CAM,15551,7499,8052,13928,1623,ITF,ITF3,15,Campania
2021-05-08,PAT,3151,1721,1430,2734,417,ITH,ITH2,4,Provincia Autonoma Trento
2021-02-16,CAL,1534,642,892,1256,278,ITF,ITF6,18,Calabria
2021-03-18,MAR,3389,1475,1914,162,3227,ITI,ITI3,11,Marche
2021-03-22,PAB,1133,514,619,1129,4,ITH,ITH1,4,Provincia Autonoma Bolzano / Bozen
2021-01-05,ABR,1614,604,1010,1614,0,ITF,ITF1,13,Abruzzo
2021-01-19,BAS,199,84,115,199,0,ITF,ITF5,17,Basilicata
2021-02-16,PUG,3379,1452,1927,2735,644,ITF,ITF4,16,Puglia
2021-03-04,MOL,850,417,433,526,324,ITF,ITF2,14,Molise
2021-03-22,UMB,3559,1654,1905,2313,1246,ITI,ITI2,10,Umbria
2021-02-09,PAB,317,126,191,1,316,ITH,ITH1,4,Provincia Autonoma Bolzano / Bozen
2021-04-14,SIC,20293,9799,10494,11508,8785,ITG,ITG1,19,Sicilia
2021-04-21,FVG,7702,3439,4263,4022,3680,ITH,ITH4,6,Friuli-Venezia Giulia
2021-05-08,FVG,10239,4628,5611,5464,4775,ITH,ITH4,6,Friuli-Venezia Giulia
2021-01-08,PIE,5531,1761,3770,5531,0,ITC,ITC1,1,Piemonte
2021-04-23,SIC,28892,13846,15046,22945,5947,ITG,ITG1,19,Sicilia
2020-12-31,PIE,3909,1334,2575,3909,0,ITC,ITC1,1,Piemonte
2021-02-08,VDA,223,83,140,25,198,ITC,ITC2,2,Valle d'Aosta / Vallée d'Aoste
2021-03-31,UMB,3903,1733,2170,2216,1687,ITI,ITI2,10,Umbria
2021-02-12,EMR,5320,1679,3641,3917,1403,ITH,ITH5,8,Emilia-Romagna
2021-02-24,CAM,11787,4149,7638,11099,688,ITF,ITF3,15,Campania
2021-05-04,ABR,10694,5039,5655,7076,3618,ITF,ITF1,13,Abruzzo
2021-02-04,LIG,2816,985,1831,179,2637,ITC,ITC3,7,Liguria
2021-03-09,TOS,10673,4151,6522,5121,5552,ITI,ITI1,9,Toscana
2021-01-10,PAT,84,19,65,84,0,ITH,ITH2,4,Provincia Autonoma Trento
2021-01-14,MOL,646,239,407,646,0,ITF,ITF2,14,Molise
2021-02-25,MAR,3510,1434,2076,3331,179,ITI,ITI3,11,Marche
2021-03-14,SAR,607,376,231,607,0,ITG,ITG2,20,Sardegna
2021-02-20,LAZ,9204,4273,4931,8437,767,ITI,ITI4,12,Lazio
2021-04-06,CAM,24375,11422,12953,19854,4521,ITF,ITF3,15,Campania
2021-05-14,LIG,12881,5649,7232,8583,4298,ITC,ITC3,7,Liguria
2021-02-27,TOS,1981,754,1227,1079,902,ITI,ITI1,9,Toscana
2021-03-17,PAB,581,213,368,580,1,ITH,ITH1,4,Provincia Autonoma Bolzano / Bozen
2021-01-17,LIG,862,300,562,862,0,ITC,ITC3,7,Liguria
2021-02-28,LIG,1060,581,479,1051,9,ITC,ITC3,7,Liguria
2021-03-24,VDA,515,230,285,258,257,ITC,ITC2,2,Valle d'Aosta / Vallée d'Aoste
2021-04-06,PIE,20237,8809,11428,15041,5196,ITC,ITC1,1,Piemonte
2021-04-11,PAB,2720,1291,1429,2543,177,ITH,ITH1,4,Provincia Autonoma Bolzano / Bozen
2021-04-24,PAT,3507,1682,1825,3494,13,ITH,ITH2,4,Provincia Autonoma Trento
2020-12-30,LIG,12,5,7,12,0,ITC,ITC3,7,Liguria
2021-01-16,BAS,721,304,417,721,0,ITF,ITF5,17,Basilicata
2021-01-25,TOS,5127,1896,3231,248,4879,ITI,ITI1,9,Toscana
2021-01-28,UMB,1247,394,853,19,1228,ITI,ITI2,10,Umbria
2021-04-21,SAR,13618,6250,7368,7015,6603,ITG,ITG2,20,Sardegna
2021-05-14,CAM,60798,27456,33342,36312,24486,ITF,ITF3,15,Campania
2021-05-19,PIE,32687,15053,17634,21883,10804,ITC,ITC1,1,Piemonte
2020-12-27,MAR,200,97,103,200,0,ITI,ITI3,11,Marche
2021-01-10,VEN,5032,1671,3361,5032,0,ITH,ITH3,5,Veneto
2021-01-18,ABR,122,48,74,46,76,ITF,ITF1,13,Abruzzo
2021-02-28,CAM,10412,3206,7206,8512,1900,ITF,ITF3,15,Campania
2021-03-01,EMR,10085,3574,6511,7832,2253,ITH,ITH5,8,Emilia-Romagna
2021-03-14,PAT,107,65,42,20,87,ITH,ITH2,4,Provincia Autonoma Trento
2021-01-29,LOM,13439,4115,9324,655,12784,ITC,ITC4,3,Lombardia
2021-01-31,PAT,75,15,60,1,74,ITH,ITH2,4,Provincia Autonoma Trento
2021-04-12,TOS,2609,1182,1427,1955,654,ITI,ITI1,9,Toscana
2021-01-10,UMB,1070,277,793,1070,0,ITI,ITI2,10,Umbria
2021-02-07,PIE,3087,974,2113,445,2642,ITC,ITC1,1,Piemonte
2021-04-05,SIC,8024,3959,4065,6584,1440,ITG,ITG1,19,Sicilia
2021-04-30,EMR,36488,16724,19764,21709,14779,ITH,ITH5,8,Emilia-Romagna
2021-02-24,LOM,14675,5928,8747,13747,928,ITC,ITC4,3,Lombardia
2021-04-26,CAM,33984,16628,17356,28361,5623,ITF,ITF3,15,Campania
2021-01-23,LIG,809,295,514,153,656,ITC,ITC3,7,Liguria
2021-03-14,FVG,1395,547,848,1143,252,ITH,ITH4,6,Friuli-Venezia Giulia
2021-04-12,PIE,22914,10345,12569,19931,2983,ITC,ITC1,1,Piemonte
2021-05-21,MAR,12951,6113,6838,6696,6255,ITI,ITI3,11,Marche
2021-01-17,CAM,1155,551,604,702,453,ITF,ITF3,15,Campania
2021-02-21,CAM,5834,2239,3595,5609,225,ITF,ITF3,15,Campania
2021-03-17,UMB,3331,1313,2018,1859,1472,ITI,ITI2,10,Umbria
2021-05-17,LIG,11791,5348,6443,8500,3291,ITC,ITC3,7,Liguria
2021-01-15,ABR,379,149,230,379,0,ITF,ITF1,13,Abruzzo
2021-02-02,VDA,272,70,202,2,270,ITC,ITC2,2,Valle d'Aosta / Vallée d'Aoste
2021-04-01,ABR,5545,2458,3087,3458,2087,ITF,ITF1,13,Abruzzo
2021-04-06,LIG,13171,5857,7314,10931,2240,ITC,ITC3,7,Liguria
2021-04-26,LIG,10440,4912,5528,7825,2615,ITC,ITC3,7,Liguria
2021-05-03,LAZ,38999,17596,21403,26509,12490,ITI,ITI4,12,Lazio
2021-04-08,SAR,13425,5923,7502,8307,5118,ITG,ITG2,20,Sardegna
2021-05-04,VDA,1135,510,625,462,673,ITC,ITC2,2,Valle d'Aosta / Vallée d'Aoste
2021-01-02,TOS,3497,1096,2401,3497,0,ITI,ITI1,9,Toscana
2021-02-10,PAT,851,291,560,509,342,ITH,ITH2,4,Provincia Autonoma Trento
2021-05-03,TOS,11922,5502,6420,10606,1316,ITI,ITI1,9,Toscana
2021-02-08,ABR,1197,396,801,487,710,ITF,ITF1,13,Abruzzo
2021-05-05,TOS,29976,13348,16628,15619,14357,ITI,ITI1,9,Toscana
2021-02-07,LIG,407,153,254,2,405,ITC,ITC3,7,Liguria
2021-02-20,LOM,9438,3901,5537,9139,299,ITC,ITC4,3,Lombardia
2021-05-10,CAM,35403,16370,19033,25493,9910,ITF,ITF3,15,Campania
2021-02-17,EMR,6538,2764,3774,5765,773,ITH,ITH5,8,Emilia-Romagna
2021-02-24,ABR,3302,1439,1863,3126,176,ITF,ITF1,13,Abruzzo
2021-05-19,FVG,11477,5661,5816,9362,2115,ITH,ITH4,6,Friuli-Venezia Giulia
2021-05-09,LAZ,37517,17248,20269,26253,11264,ITI,ITI4,12,Lazio
2021-01-29,ABR,1386,449,937,74,1312,ITF,ITF1,13,Abruzzo
2021-03-12,CAL,5079,2432,2647,4036,1043,ITF,ITF6,18,Calabria
2021-05-01,TOS,23290,10050,13240,14120,9170,ITI,ITI1,9,Toscana
2021-02-18,SAR,1878,732,1146,1814,64,ITG,ITG2,20,Sardegna
2021-01-21,CAM,2092,1115,977,676,1416,ITF,ITF3,15,Campania
2021-02-16,EMR,5766,2443,3323,5235,531,ITH,ITH5,8,Emilia-Romagna
2021-02-25,PAB,1498,549,949,1497,1,ITH,ITH1,4,Provincia Autonoma Bolzano / Bozen
2021-05-12,PUG,35907,15931,19976,23550,12357,ITF,ITF4,16,Puglia
2021-01-03,LAZ,5250,1972,3278,5250,0,ITI,ITI4,12,Lazio
2021-01-12,FVG,2260,713,1547,2260,0,ITH,ITH4,6,Friuli-Venezia Giulia
2021-03-13,LAZ,21412,8407,13005,15518,5894,ITI,ITI4,12,Lazio
2021-03-29,CAM,18946,9134,9812,17400,1546,ITF,ITF3,15,Campania
2021-03-31,EMR,25125,10947,14178,19668,5457,ITH,ITH5,8,Emilia-Romagna
2021-05-11,CAL,15102,7302,7800,10328,4774,ITF,ITF6,18,Calabria
2021-02-18,EMR,7039,2892,4147,6456,583,ITH,ITH5,8,Emilia-Romagna
2021-03-29,CAL,5627,2380,3247,3872,1755,ITF,ITF6,18,Calabria
2021-04-23,LIG,14382,6518,7864,8262,6120,ITC,ITC3,7,Liguria
2021-05-12,TOS,34059,15504,18555,14130,19929,ITI,ITI1,9,Toscana
2021-02-03,LAZ,6488,2488,4000,964,5524,ITI,ITI4,12,Lazio
2021-03-05,PIE,15266,5959,9307,11449,3817,ITC,ITC1,1,Piemonte
2021-03-23,MAR,5789,2529,3260,2262,3527,ITI,ITI3,11,Marche
2021-04-05,LIG,3976,1751,2225,2327,1649,ITC,ITC3,7,Liguria
2021-01-08,SAR,3258,1184,2074,3258,0,ITG,ITG2,20,Sardegna
2021-05-11,EMR,35061,16434,18627,27810,7251,ITH,ITH5,8,Emilia-Romagna
2021-05-14,SIC,52075,24386,27689,36247,15828,ITG,ITG1,19,Sicilia
2021-03-18,PIE,11742,4798,6944,4029,7713,ITC,ITC1,1,Piemonte
2021-05-09,MAR,8772,3986,4786,3641,5131,ITI,ITI3,11,Marche
2021-01-21,PIE,6923,2318,4605,3427,3496,ITC,ITC1,1,Piemonte
2021-04-02,PAT,2787,1143,1644,2113,674,ITH,ITH2,4,Provincia Autonoma Trento
2021-04-30,BAS,5286,2373,2913,4121,1165,ITF,ITF5,17,Basilicata
2021-01-01,PAT,213,50,163,213,0,ITH,ITH2,4,Provincia Autonoma Trento
2021-03-03,PAB,1178,393,785,1165,13,ITH,ITH1,4,Provincia Autonoma Bolzano / Bozen
2021-01-03,SIC,4702,2459,2243,4702,0,ITG,ITG1,19,Sicilia
2021-04-21,BAS,3921,1835,2086,2271,1650,ITF,ITF5,17,Basilicata
2021-02-27,UMB,1658,354,1304,1642,16,ITI,ITI2,10,Umbria
2021-03-24,TOS,19655,7973,11682,10199,9456,ITI,ITI1,9,Toscana
2021-04-07,VDA,908,473,435,679,229,ITC,ITC2,2,Valle d'Aosta / Vallée d'Aoste
2021-05-04,BAS,4132,1989,2143,3609,523,ITF,ITF5,17,Basilicata
2021-01-12,PAT,505,158,347,505,0,ITH,ITH2,4,Provincia Autonoma Trento
2021-03-09,CAL,5825,3036,2789,4848,977,ITF,ITF6,18,Calabria
2021-04-11,PIE,20822,9315,11507,18661,2161,ITC,ITC1,1,Piemonte
2021-02-03,SIC,6107,2860,3247,756,5351,ITG,ITG1,19,Sicilia
2021-03-24,LAZ,25880,11299,14581,19643,6237,ITI,ITI4,12,Lazio
2020-12-31,LIG,989,354,635,989,0,ITC,ITC3,7,Liguria
2021-04-06,UMB,5290,2169,3121,2901,2389,ITI,ITI2,10,Umbria
2021-03-03,UMB,4438,1773,2665,3727,711,ITI,ITI2,10,Umbria
2021-03-23,LAZ,23492,10223,13269,16916,6576,ITI,ITI4,12,Lazio
2021-05-22,TOS,24255,11778,12477,20407,3848,ITI,ITI1,9,Toscana
2021-04-02,PUG,12584,5764,6820,8066,4518,ITF,ITF4,16,Puglia
2021-05-17,UMB,6331,3046,3285,4169,2162,ITI,ITI2,10,Umbria
2021-02-23,PIE,9233,3713,5520,8653,580,ITC,ITC1,1,Piemonte
2021-01-20,MAR,398,100,298,384,14,ITI,ITI3,11,Marche
2021-01-26,SIC,9480,4666,4814,261,9219,ITG,ITG1,19,Sicilia
2021-03-09,FVG,3855,1589,2266,1108,2747,ITH,ITH4,6,Friuli-Venezia Giulia
2021-03-21,UMB,665,330,335,665,0,ITI,ITI2,10,Umbria
2021-04-01,MOL,1454,662,792,729,725,ITF,ITF2,14,Molise
2021-04-04,SAR,1,0,1,0,1,ITG,ITG2,20,Sardegna
2021-04-11,ABR,5330,2606,2724,4847,483,ITF,ITF1,13,Abruzzo
2021-03-06,MOL,1728,807,921,1569,159,ITF,ITF2,14,Molise
2021-03-11,LIG,6352,3054,3298,4346,2006,ITC,ITC3,7,Liguria
2021-03-14,BAS,1008,477,531,539,469,ITF,ITF5,17,Basilicata
2021-05-13,FVG,10951,5260,5691,8963,1988,ITH,ITH4,6,Friuli-Venezia Giulia
2021-05-20,CAM,60390,27802,32588,43058,17332,ITF,ITF3,15,Campania
2021-01-10,MAR,1737,699,1038,1737,0,ITI,ITI3,11,Marche
2021-02-12,BAS,775,332,443,744,31,ITF,ITF5,17,Basilicata
2021-03-22,VDA,560,205,355,333,227,ITC,ITC2,2,Valle d'Aosta / Vallée d'Aoste
2021-03-24,MAR,7031,2982,4049,3363,3668,ITI,ITI3,11,Marche
2021-03-29,LOM,40003,15509,24494,25181,14822,ITC,ITC4,3,Lombardia
2021-01-01,PUG,147,60,87,147,0,ITF,ITF4,16,Puglia
2021-04-09,SIC,20535,10002,10533,11388,9147,ITG,ITG1,19,Sicilia
2021-04-25,PAB,3069,1496,1573,2398,671,ITH,ITH1,4,Provincia Autonoma Bolzano / Bozen
2021-01-12,PUG,4212,1772,2440,4212,0,ITF,ITF4,16,Puglia
2021-03-23,TOS,9091,4101,4990,6817,2274,ITI,ITI1,9,Toscana
2021-02-06,LAZ,6135,2474,3661,817,5318,ITI,ITI4,12,Lazio
2021-02-16,LOM,9543,3086,6457,9087,456,ITC,ITC4,3,Lombardia
2021-02-27,VEN,8987,2691,6296,8140,847,ITH,ITH3,5,Veneto
2021-03-29,FVG,6874,3001,3873,5294,1580,ITH,ITH4,6,Friuli-Venezia Giulia
2021-04-16,LAZ,34368,15667,18701,22312,12056,ITI,ITI4,12,Lazio
2021-05-16,ABR,9575,4136,5439,5764,3811,ITF,ITF1,13,Abruzzo
2021-01-04,LIG,2617,855,1762,2617,0,ITC,ITC3,7,Liguria
2021-03-09,PAT,1580,589,991,937,643,ITH,ITH2,4,Provincia Autonoma Trento
2021-04-16,SIC,28746,14424,14322,20371,8375,ITG,ITG1,19,Sicilia
2021-03-04,PUG,15073,5880,9193,13685,1388,ITF,ITF4,16,Puglia
2021-04-24,BAS,4546,2198,2348,3534,1012,ITF,ITF5,17,Basilicata
2021-01-09,LOM,12410,4573,7837,12410,0,ITC,ITC4,3,Lombardia
2021-02-11,PAT,1132,365,767,796,336,ITH,ITH2,4,Provincia Autonoma Trento
2021-02-26,PIE,12292,4932,7360,11555,737,ITC,ITC1,1,Piemonte
2021-01-19,LAZ,4768,1954,2814,4314,454,ITI,ITI4,12,Lazio
2021-02-18,UMB,1496,582,914,1030,466,ITI,ITI2,10,Umbria
2021-04-25,MOL,787,393,394,558,229,ITF,ITF2,14,Molise
2021-05-03,LIG,13265,5920,7345,6454,6811,ITC,ITC3,7,Liguria
2021-05-09,VDA,574,287,287,444,130,ITC,ITC2,2,Valle d'Aosta / Vallée d'Aoste
2021-03-03,MOL,672,316,356,590,82,ITF,ITF2,14,Molise
2021-05-14,MAR,13492,6217,7275,6720,6772,ITI,ITI3,11,Marche
2021-02-05,TOS,5749,2245,3504,1924,3825,ITI,ITI1,9,Toscana
2021-02-06,SIC,5013,2188,2825,1462,3551,ITG,ITG1,19,Sicilia
2021-02-17,ABR,2071,948,1123,1789,282,ITF,ITF1,13,Abruzzo
2021-04-25,LIG,1936,921,1015,1521,415,ITC,ITC3,7,Liguria
2021-01-25,PIE,6214,1938,4276,983,5231,ITC,ITC1,1,Piemonte
2021-04-12,PAT,3077,1401,1676,2581,496,ITH,ITH2,4,Provincia Autonoma Trento
2021-03-15,LIG,7302,3076,4226,4598,2704,ITC,ITC3,7,Liguria
2021-03-18,CAM,12171,5378,6793,5983,6188,ITF,ITF3,15,Campania
2021-05-11,SAR,8628,3980,4648,6298,2330,ITG,ITG2,20,Sardegna
2021-01-17,VDA,131,56,75,131,0,ITC,ITC2,2,Valle d'Aosta / Vallée d'Aoste
2021-01-08,UMB,1190,345,845,1190,0,ITI,ITI2,10,Umbria
2021-03-05,CAM,16479,6348,10131,9818,6661,ITF,ITF3,15,Campania
2021-03-20,ABR,4759,2179,2580,2591,2168,ITF,ITF1,13,Abruzzo
2020-12-31,UMB,322,127,195,322,0,ITI,ITI2,10,Umbria
2021-03-19,FVG,3233,1339,1894,1301,1932,ITH,ITH4,6,Friuli-Venezia Giulia
2021-02-26,CAM,13339,4230,9109,12004,1335,ITF,ITF3,15,Campania
2021-02-10,VDA,248,77,171,141,107,ITC,ITC2,2,Valle d'Aosta / Vallée d'Aoste
2021-02-18,PAB,1839,457,1382,1832,7,ITH,ITH1,4,Provincia Autonoma Bolzano / Bozen
2021-02-21,LIG,869,491,378,865,4,ITC,ITC3,7,Liguria
2021-02-27,EMR,10966,3999,6967,9228,1738,ITH,ITH5,8,Emilia-Romagna
2021-03-28,FVG,4807,2271,2536,4667,140,ITH,ITH4,6,Friuli-Venezia Giulia
2021-01-07,LOM,11761,3636,8125,11761,0,ITC,ITC4,3,Lombardia
2021-01-16,MOL,420,166,254,420,0,ITF,ITF2,14,Molise
2021-01-25,ABR,1603,632,971,19,1584,ITF,ITF1,13,Abruzzo
2021-02-27,SAR,1921,647,1274,1366,555,ITG,ITG2,20,Sardegna
2021-02-05,LAZ,7275,2960,4315,1183,6092,ITI,ITI4,12,Lazio
2021-02-11,TOS,5383,2021,3362,5141,242,ITI,ITI1,9,Toscana
2021-04-11,UMB,3102,1503,1599,3053,49,ITI,ITI2,10,Umbria
2021-05-10,FVG,7839,3478,4361,6312,1527,ITH,ITH4,6,Friuli-Venezia Giulia
2021-01-07,CAM,8910,4166,4744,8910,0,ITF,ITF3,15,Campania
2021-01-08,PAB,1521,479,1042,1521,0,ITH,ITH1,4,Provincia Autonoma Bolzano / Bozen
2021-04-04,VEN,7776,3531,4245,6625,1151,ITH,ITH3,5,Veneto
2020-12-31,PAB,912,518,394,912,0,ITH,ITH1,4,Provincia Autonoma Bolzano / Bozen
2021-01-25,PUG,3823,1680,2143,423,3400,ITF,ITF4,16,Puglia
2021-02-02,TOS,3742,1475,2267,195,3547,ITI,ITI1,9,Toscana
2021-02-11,PUG,3699,1402,2297,2422,1277,ITF,ITF4,16,Puglia
2021-04-03,MOL,1766,848,918,1732,34,ITF,ITF2,14,Molise
2021-02-07,MAR,1868,734,1134,344,1524,ITI,ITI3,11,Marche
2021-02-19,PAB,2252,512,1740,2241,11,ITH,ITH1,4,Provincia Autonoma Bolzano / Bozen
2021-03-23,VDA,379,150,229,245,134,ITC,ITC2,2,Valle d'Aosta / Vallée d'Aoste
2021-04-10,TOS,11721,5348,6373,10975,746,ITI,ITI1,9,Toscana
2021-04-26,VDA,715,327,388,545,170,ITC,ITC2,2,Valle d'Aosta / Vallée d'Aoste
2021-04-29,PUG,25745,11913,13832,19117,6628,ITF,ITF4,16,Puglia
2021-04-29,CAL,11591,5632,5959,8285,3306,ITF,ITF6,18,Calabria
2021-05-15,TOS,29241,13805,15436,23523,5718,ITI,ITI1,9,Toscana
2021-05-17,EMR,30223,14356,15867,20883,9340,ITH,ITH5,8,Emilia-Romagna
2021-02-04,SAR,2271,816,1455,916,1355,ITG,ITG2,20,Sardegna
2021-02-20,CAL,1357,735,622,1042,315,ITF,ITF6,18,Calabria
2021-03-03,PIE,12120,4644,7476,11301,819,ITC,ITC1,1,Piemonte
2021-01-09,EMR,9945,3440,6505,9945,0,ITH,ITH5,8,Emilia-Romagna
2021-02-23,UMB,1693,658,1035,1651,42,ITI,ITI2,10,Umbria
2021-02-27,ABR,2810,1337,1473,2544,266,ITF,ITF1,13,Abruzzo
2021-02-01,CAL,2494,1191,1303,243,2251,ITF,ITF6,18,Calabria
2021-03-17,BAS,1451,608,843,27,1424,ITF,ITF5,17,Basilicata
2021-04-05,UMB,4250,1728,2522,2195,2055,ITI,ITI2,10,Umbria
2021-04-12,PUG,29062,13689,15373,26238,2824,ITF,ITF4,16,Puglia
2021-04-30,MOL,2914,1542,1372,828,2086,ITF,ITF2,14,Molise
2021-04-12,ABR,6225,2950,3275,5051,1174,ITF,ITF1,13,Abruzzo
2021-01-08,EMR,10837,3570,7267,10837,0,ITH,ITH5,8,Emilia-Romagna
2021-01-19,SIC,1287,530,757,1095,192,ITG,ITG1,19,Sicilia
2021-02-18,VEN,5828,2455,3373,5764,64,ITH,ITH3,5,Veneto
2021-04-05,MOL,389,188,201,290,99,ITF,ITF2,14,Molise
2021-01-06,MOL,689,260,429,689,0,ITF,ITF2,14,Molise
2021-02-24,EMR,9323,3556,5767,8443,880,ITH,ITH5,8,Emilia-Romagna
2021-01-01,PIE,1038,395,643,1038,0,ITC,ITC1,1,Piemonte
2021-04-08,MAR,7522,3285,4237,7195,327,ITI,ITI3,11,Marche
2021-05-11,VEN,32660,16277,16383,28118,4542,ITH,ITH3,5,Veneto
2021-01-17,FVG,1716,523,1193,1716,0,ITH,ITH4,6,Friuli-Venezia Giulia
2021-04-11,LOM,32178,13935,18243,24786,7392,ITC,ITC4,3,Lombardia
2021-04-13,SIC,19917,9689,10228,11082,8835,ITG,ITG1,19,Sicilia
2021-05-11,LOM,86558,41310,45248,60536,26022,ITC,ITC4,3,Lombardia
2021-03-09,PUG,13184,5748,7436,11177,2007,ITF,ITF4,16,Puglia
2021-04-26,FVG,5442,2444,2998,3794,1648,ITH,ITH4,6,Friuli-Venezia Giulia
2021-02-20,PAT,407,245,162,123,284,ITH,ITH2,4,Provincia Autonoma Trento
2021-02-07,SIC,2344,995,1349,674,1670,ITG,ITG1,19,Sicilia
2021-03-21,CAL,4355,1882,2473,2655,1700,ITF,ITF6,18,Calabria
2021-01-13,LIG,2755,1014,1741,2755,0,ITC,ITC3,7,Liguria
2021-02-25,VEN,7899,3339,4560,7294,605,ITH,ITH3,5,Veneto
2021-03-16,PIE,10519,4268,6251,4463,6056,ITC,ITC1,1,Piemonte
2021-01-04,MOL,314,131,183,314,0,ITF,ITF2,14,Molise
2021-03-12,PUG,13923,6103,7820,9998,3925,ITF,ITF4,16,Puglia
2021-04-08,SIC,16795,8287,8508,8312,8483,ITG,ITG1,19,Sicilia
2021-01-05,MOL,449,180,269,449,0,ITF,ITF2,14,Molise
2021-03-06,PIE,13993,5211,8782,11204,2789,ITC,ITC1,1,Piemonte
2021-05-02,SIC,24656,11447,13209,18055,6601,ITG,ITG1,19,Sicilia
2021-02-06,MOL,429,179,250,29,400,ITF,ITF2,14,Molise
2021-02-27,PAT,1026,456,570,605,421,ITH,ITH2,4,Provincia Autonoma Trento
2021-03-21,FVG,2602,937,1665,2193,409,ITH,ITH4,6,Friuli-Venezia Giulia
2021-01-30,LIG,1661,567,1094,25,1636,ITC,ITC3,7,Liguria
2021-02-19,EMR,7327,3010,4317,6813,514,ITH,ITH5,8,Emilia-Romagna
2021-04-16,MOL,2411,1027,1384,1184,1227,ITF,ITF2,14,Molise
2021-04-28,EMR,32633,15071,17562,19753,12880,ITH,ITH5,8,Emilia-Romagna
2021-05-11,ABR,10654,5057,5597,5826,4828,ITF,ITF1,13,Abruzzo
2021-02-01,PAT,1220,335,885,92,1128,ITH,ITH2,4,Provincia Autonoma Trento
2021-02-16,BAS,905,377,528,807,98,ITF,ITF5,17,Basilicata
2021-04-18,PIE,22947,10816,12131,20193,2754,ITC,ITC1,1,Piemonte
2021-05-11,BAS,2646,1349,1297,1613,1033,ITF,ITF5,17,Basilicata
2021-05-08,TOS,29071,13079,15992,13672,15399,ITI,ITI1,9,Toscana
2021-04-20,UMB,5435,2353,3082,3488,1947,ITI,ITI2,10,Umbria
2021-05-07,PIE,32785,15485,17300,18809,13976,ITC,ITC1,1,Piemonte
2021-03-16,SAR,4374,1949,2425,3452,922,ITG,ITG2,20,Sardegna
2021-05-03,EMR,27831,13156,14675,16963,10868,ITH,ITH5,8,Emilia-Romagna
2021-02-18,ABR,2288,933,1355,2158,130,ITF,ITF1,13,Abruzzo
2021-02-25,UMB,1336,497,839,1284,52,ITI,ITI2,10,Umbria
2021-04-17,CAM,36172,17506,18666,24666,11506,ITF,ITF3,15,Campania
2021-04-28,SAR,8799,4155,4644,5104,3695,ITG,ITG2,20,Sardegna
2021-04-30,CAL,14679,7220,7459,10597,4082,ITF,ITF6,18,Calabria
2021-03-13,TOS,9274,3300,5974,5312,3962,ITI,ITI1,9,Toscana
2021-04-23,MOL,2048,881,1167,1389,659,ITF,ITF2,14,Molise
2021-04-15,LAZ,31878,14292,17586,21081,10797,ITI,ITI4,12,Lazio
2021-03-02,SIC,14879,6361,8518,12070,2809,ITG,ITG1,19,Sicilia
2021-01-28,MAR,2085,724,1361,165,1920,ITI,ITI3,11,Marche
2021-02-06,LIG,1892,768,1124,145,1747,ITC,ITC3,7,Liguria
2021-02-14,SAR,539,263,276,537,2,ITG,ITG2,20,Sardegna
2021-03-16,PAB,1290,532,758,124,1166,ITH,ITH1,4,Provincia Autonoma Bolzano / Bozen
2021-04-12,FVG,7253,3181,4072,6122,1131,ITH,ITH4,6,Friuli-Venezia Giulia
2021-04-16,LIG,11976,5282,6694,10165,1811,ITC,ITC3,7,Liguria
2021-04-05,EMR,14856,6807,8049,11963,2893,ITH,ITH5,8,Emilia-Romagna
2021-05-20,LOM,93504,45242,48262,31590,61914,ITC,ITC4,3,Lombardia
2021-03-26,VEN,29538,13115,16423,24072,5466,ITH,ITH3,5,Veneto
2021-04-05,SAR,2036,784,1252,2035,1,ITG,ITG2,20,Sardegna
2021-01-09,ABR,1483,565,918,1483,0,ITF,ITF1,13,Abruzzo
2021-02-27,BAS,1991,859,1132,1827,164,ITF,ITF5,17,Basilicata
2021-03-21,LOM,23577,8549,15028,18316,5261,ITC,ITC4,3,Lombardia
2021-04-22,PIE,27610,12704,14906,20919,6691,ITC,ITC1,1,Piemonte
2021-01-08,ABR,1525,507,1018,1525,0,ITF,ITF1,13,Abruzzo
2021-02-19,ABR,3300,1551,1749,3200,100,ITF,ITF1,13,Abruzzo
2021-02-20,PUG,2969,1080,1889,2713,256,ITF,ITF4,16,Puglia
2021-03-25,SIC,20528,9540,10988,14989,5539,ITG,ITG1,19,Sicilia
2021-01-07,PUG,5715,2456,3259,5715,0,ITF,ITF4,16,Puglia
2021-03-12,PAT,2494,931,1563,1689,805,ITH,ITH2,4,Provincia Autonoma Trento
2021-03-25,LAZ,26910,11509,15401,20311,6599,ITI,ITI4,12,Lazio
2021-05-21,PAT,3894,1842,2052,2418,1476,ITH,ITH2,4,Provincia Autonoma Trento
2021-01-08,VEN,9404,2836,6568,9404,0,ITH,ITH3,5,Veneto
2021-01-25,FVG,1584,568,1016,194,1390,ITH,ITH4,6,Friuli-Venezia Giulia
2021-01-06,BAS,294,129,165,294,0,ITF,ITF5,17,Basilicata
2021-02-01,PUG,3965,1659,2306,375,3590,ITF,ITF4,16,Puglia
2021-02-03,MOL,731,249,482,338,393,ITF,ITF2,14,Molise
2021-03-01,BAS,547,284,263,381,166,ITF,ITF5,17,Basilicata
2021-01-26,PAB,810,291,519,1,809,ITH,ITH1,4,Provincia Autonoma Bolzano / Bozen
2021-04-04,PIE,9254,4059,5195,6541,2713,ITC,ITC1,1,Piemonte
2020-12-27,PIE,913,369,544,913,0,ITC,ITC1,1,Piemonte
2021-02-14,VEN,125,56,69,112,13,ITH,ITH3,5,Veneto
2021-02-17,BAS,1135,493,642,1059,76,ITF,ITF5,17,Basilicata
2021-04-09,MOL,2296,1240,1056,2105,191,ITF,ITF2,14,Molise
2021-02-04,BAS,1095,442,653,63,1032,ITF,ITF5,17,Basilicata
2021-02-19,SAR,1499,473,1026,1443,56,ITG,ITG2,20,Sardegna
2021-04-01,PAB,2786,1407,1379,2642,144,ITH,ITH1,4,Provincia Autonoma Bolzano / Bozen
2021-01-07,ABR,1603,552,1051,1603,0,ITF,ITF1,13,Abruzzo
2021-01-07,PAT,1270,310,960,1270,0,ITH,ITH2,4,Provincia Autonoma Trento
2021-01-22,PIE,3866,1249,2617,2525,1341,ITC,ITC1,1,Piemonte
2021-02-15,VDA,264,136,128,229,35,ITC,ITC2,2,Valle d'Aosta / Vallée d'Aoste
2021-03-16,VEN,12516,5347,7169,6902,5614,ITH,ITH3,5,Veneto
2021-04-13,LIG,13052,5860,7192,11033,2019,ITC,ITC3,7,Liguria
2021-01-19,LIG,1371,438,933,1281,90,ITC,ITC3,7,Liguria
2021-03-06,CAM,16309,6753,9556,10641,5668,ITF,ITF3,15,Campania
2021-04-25,EMR,22311,10215,12096,14807,7504,ITH,ITH5,8,Emilia-Romagna
2021-05-07,CAM,59680,29169,30511,43753,15927,ITF,ITF3,15,Campania
2021-05-20,FVG,12047,5937,6110,9766,2281,ITH,ITH4,6,Friuli-Venezia Giulia
2021-05-21,PUG,36207,16957,19250,27111,9096,ITF,ITF4,16,Puglia
2021-01-03,PAB,41,16,25,41,0,ITH,ITH1,4,Provincia Autonoma Bolzano / Bozen
2021-01-21,FVG,895,345,550,1,894,ITH,ITH4,6,Friuli-Venezia Giulia
2021-04-22,CAM,33929,16524,17405,21528,12401,ITF,ITF3,15,Campania
2021-05-19,VDA,991,498,493,418,573,ITC,ITC2,2,Valle d'Aosta / Vallée d'Aoste
2021-03-21,CAM,9984,4592,5392,7594,2390,ITF,ITF3,15,Campania
2021-03-26,SAR,8087,3178,4909,6562,1525,ITG,ITG2,20,Sardegna
2021-03-08,CAM,14538,6716,7822,9762,4776,ITF,ITF3,15,Campania
2021-03-10,CAM,15248,7378,7870,8415,6833,ITF,ITF3,15,Campania
2021-05-18,TOS,28548,14061,14487,19938,8610,ITI,ITI1,9,Toscana
2021-01-15,MOL,538,242,296,538,0,ITF,ITF2,14,Molise
2021-02-23,CAM,11003,3388,7615,10477,526,ITF,ITF3,15,Campania
2021-02-25,MOL,541,239,302,473,68,ITF,ITF2,14,Molise
2021-04-25,UMB,4363,1685,2678,4281,82,ITI,ITI2,10,Umbria
2021-02-09,EMR,4152,1247,2905,2306,1846,ITH,ITH5,8,Emilia-Romagna
2021-03-03,CAM,13919,5492,8427,7289,6630,ITF,ITF3,15,Campania
2021-03-26,LOM,41173,15615,25558,28107,13066,ITC,ITC4,3,Lombardia
2021-03-28,VDA,522,212,310,521,1,ITC,ITC2,2,Valle d'Aosta / Vallée d'Aoste
2021-03-30,SIC,14595,6759,7836,9769,4826,ITG,ITG1,19,Sicilia
2021-01-06,SAR,1615,549,1066,1615,0,ITG,ITG2,20,Sardegna
2021-02-25,SAR,2899,1255,1644,2294,605,ITG,ITG2,20,Sardegna
2021-04-04,LOM,7617,3232,4385,3718,3899,ITC,ITC4,3,Lombardia
2021-05-03,VEN,40487,19722,20765,34072,6415,ITH,ITH3,5,Veneto
2021-01-03,LIG,734,230,504,734,0,ITC,ITC3,7,Liguria
2021-02-19,UMB,743,293,450,526,217,ITI,ITI2,10,Umbria
2021-03-27,LAZ,26008,10395,15613,19539,6469,ITI,ITI4,12,Lazio
2020-12-29,SAR,57,32,25,57,0,ITG,ITG2,20,Sardegna
2021-01-18,LAZ,6264,2555,3709,5286,978,ITI,ITI4,12,Lazio
2021-05-03,SAR,8174,3813,4361,6577,1597,ITG,ITG2,20,Sardegna
2021-02-16,ABR,1918,842,1076,1906,12,ITF,ITF1,13,Abruzzo
2021-04-17,PIE,30323,14091,16232,27045,3278,ITC,ITC1,1,Piemonte
2021-02-23,FVG,2617,1252,1365,2437,180,ITH,ITH4,6,Friuli-Venezia Giulia
2021-03-19,VDA,322,85,237,286,36,ITC,ITC2,2,Valle d'Aosta / Vallée d'Aoste
2021-05-10,CAL,13116,6083,7033,7726,5390,ITF,ITF6,18,Calabria
2020-12-29,LOM,104,44,60,104,0,ITC,ITC4,3,Lombardia
2021-01-18,TOS,1119,636,483,1021,98,ITI,ITI1,9,Toscana
2021-02-26,LOM,18365,7552,10813,16515,1850,ITC,ITC4,3,Lombardia
2021-03-31,BAS,3095,1258,1837,2313,782,ITF,ITF5,17,Basilicata
2021-04-30,CAM,42234,20132,22102,25788,16446,ITF,ITF3,15,Campania
2021-02-26,FVG,3735,2093,1642,3587,148,ITH,ITH4,6,Friuli-Venezia Giulia
2021-05-22,MAR,11926,5708,6218,7488,4438,ITI,ITI3,11,Marche
2021-01-11,MAR,1176,411,765,1176,0,ITI,ITI3,11,Marche
2021-01-30,MAR,1905,668,1237,29,1876,ITI,ITI3,11,Marche
2021-02-08,PUG,3992,1610,2382,1597,2395,ITF,ITF4,16,Puglia
2021-02-14,EMR,1401,378,1023,1281,120,ITH,ITH5,8,Emilia-Romagna
2021-02-22,TOS,9818,4254,5564,9541,277,ITI,ITI1,9,Toscana
2021-04-28,UMB,5339,2315,3024,2957,2382,ITI,ITI2,10,Umbria
2021-05-04,CAL,16275,7478,8797,11652,4623,ITF,ITF6,18,Calabria
2021-01-20,SIC,822,418,404,573,249,ITG,ITG1,19,Sicilia
2021-03-12,PIE,13947,5184,8763,11012,2935,ITC,ITC1,1,Piemonte
2021-05-02,LAZ,32611,14327,18284,23250,9361,ITI,ITI4,12,Lazio
2021-01-25,PAT,817,215,602,23,794,ITH,ITH2,4,Provincia Autonoma Trento
2021-01-27,TOS,4834,1572,3262,206,4628,ITI,ITI1,9,Toscana
2021-04-13,PAB,2391,1130,1261,2384,7,ITH,ITH1,4,Provincia Autonoma Bolzano / Bozen
2021-04-28,PAB,2458,1300,1158,2455,3,ITH,ITH1,4,Provincia Autonoma Bolzano / Bozen
2021-04-07,MAR,7811,3435,4376,7476,335,ITI,ITI3,11,Marche
2021-05-05,MAR,11623,5288,6335,5215,6408,ITI,ITI3,11,Marche
2021-02-10,TOS,4263,1281,2982,3740,523,ITI,ITI1,9,Toscana
2021-04-20,LIG,13775,6304,7471,9426,4349,ITC,ITC3,7,Liguria
2021-05-23,TOS,16924,8021,8903,15085,1839,ITI,ITI1,9,Toscana
2021-03-05,LOM,28987,11947,17040,20584,8403,ITC,ITC4,3,Lombardia
2021-04-23,UMB,6604,2784,3820,3485,3119,ITI,ITI2,10,Umbria
2021-02-03,LIG,2316,792,1524,55,2261,ITC,ITC3,7,Liguria
2021-02-21,EMR,4450,1708,2742,4010,440,ITH,ITH5,8,Emilia-Romagna
2021-03-26,PAB,1644,721,923,511,1133,ITH,ITH1,4,Provincia Autonoma Bolzano / Bozen
2021-01-16,PAB,2840,1265,1575,2840,0,ITH,ITH1,4,Provincia Autonoma Bolzano / Bozen
2021-02-18,BAS,1070,401,669,855,215,ITF,ITF5,17,Basilicata
2021-03-10,PIE,13629,5166,8463,11335,2294,ITC,ITC1,1,Piemonte
2021-04-27,BAS,4724,2242,2482,4399,325,ITF,ITF5,17,Basilicata
2021-01-07,CAL,2183,1063,1120,2183,0,ITF,ITF6,18,Calabria
2021-02-19,VEN,7321,3140,4181,7118,203,ITH,ITH3,5,Veneto
2021-04-04,UMB,59,20,39,23,36,ITI,ITI2,10,Umbria
2021-01-22,CAM,1524,776,748,673,851,ITF,ITF3,15,Campania
2021-02-12,CAM,6529,2861,3668,6343,186,ITF,ITF3,15,Campania
2021-02-28,EMR,6822,2527,4295,4976,1846,ITH,ITH5,8,Emilia-Romagna
2021-03-18,FVG,3371,1421,1950,1690,1681,ITH,ITH4,6,Friuli-Venezia Giulia
2021-03-26,UMB,4570,1682,2888,4398,172,ITI,ITI2,10,Umbria
2021-02-22,PUG,9627,4534,5093,9295,332,ITF,ITF4,16,Puglia
2021-01-19,MOL,173,63,110,162,11,ITF,ITF2,14,Molise
2021-03-05,FVG,3736,1478,2258,2663,1073,ITH,ITH4,6,Friuli-Venezia Giulia
2021-04-21,PIE,25680,11805,13875,20356,5324,ITC,ITC1,1,Piemonte
2021-01-06,VEN,8132,2385,5747,8132,0,ITH,ITH3,5,Veneto
2021-03-30,LAZ,25254,11583,13671,18106,7148,ITI,ITI4,12,Lazio
2021-04-28,VEN,32355,15148,17207,23332,9023,ITH,ITH3,5,Veneto
2021-02-23,CAL,1546,727,819,1431,115,ITF,ITF6,18,Calabria
2021-05-08,VDA,904,540,364,526,378,ITC,ITC2,2,Valle d'Aosta / Vallée d'Aoste
2021-03-26,EMR,23408,9898,13510,16974,6434,ITH,ITH5,8,Emilia-Romagna
2021-04-11,FVG,3433,1520,1913,2527,906,ITH,ITH4,6,Friuli-Venezia Giulia
2021-02-05,LIG,2675,986,1689,304,2371,ITC,ITC3,7,Liguria
2021-02-08,PAT,1151,318,833,342,809,ITH,ITH2,4,Provincia Autonoma Trento
2021-01-19,VDA,256,77,179,256,0,ITC,ITC2,2,Valle d'Aosta / Vallée d'Aoste
2021-02-07,PAB,2361,1057,1304,14,2347,ITH,ITH1,4,Provincia Autonoma Bolzano / Bozen
2021-04-15,TOS,24370,10182,14188,15852,8518,ITI,ITI1,9,Toscana
2021-01-08,MAR,1576,588,988,1576,0,ITI,ITI3,11,Marche
2021-05-23,MAR,6371,2982,3389,5091,1280,ITI,ITI3,11,Marche
2021-01-29,LAZ,8042,3079,4963,813,7229,ITI,ITI4,12,Lazio
2021-02-24,FVG,2518,1082,1436,2500,18,ITH,ITH4,6,Friuli-Venezia Giulia
2021-05-13,VEN,43517,21474,22043,33829,9688,ITH,ITH3,5,Veneto
2020-12-27,EMR,970,372,598,970,0,ITH,ITH5,8,Emilia-Romagna
2021-01-20,MOL,18,8,10,18,0,ITF,ITF2,14,Molise
2021-02-25,LIG,3455,1349,2106,3325,130,ITC,ITC3,7,Liguria
2021-03-04,CAM,14659,5352,9307,8766,5893,ITF,ITF3,15,Campania
2021-03-31,PUG,14033,6349,7684,8479,5554,ITF,ITF4,16,Puglia
2021-04-13,VDA,373,171,202,329,44,ITC,ITC2,2,Valle d'Aosta / Vallée d'Aoste
2021-02-08,PIE,6916,2355,4561,666,6250,ITC,ITC1,1,Piemonte
2021-03-05,TOS,16492,6336,10156,11751,4741,ITI,ITI1,9,Toscana
2021-04-03,PIE,19700,8283,11417,10890,8810,ITC,ITC1,1,Piemonte
2021-02-10,LOM,14392,4504,9888,7572,6820,ITC,ITC4,3,Lombardia
2021-03-23,PAB,1552,759,793,1551,1,ITH,ITH1,4,Provincia Autonoma Bolzano / Bozen
2021-05-04,PAB,3447,1843,1604,2410,1037,ITH,ITH1,4,Provincia Autonoma Bolzano / Bozen
2021-02-05,PAT,802,272,530,283,519,ITH,ITH2,4,Provincia Autonoma Trento
2021-04-14,LOM,47116,21009,26107,34150,12966,ITC,ITC4,3,Lombardia
2021-03-12,SAR,6699,2796,3903,5342,1357,ITG,ITG2,20,Sardegna
2021-04-10,PAT,2795,1307,1488,2001,794,ITH,ITH2,4,Provincia Autonoma Trento
2021-04-14,LIG,13019,5655,7364,10816,2203,ITC,ITC3,7,Liguria
2021-04-20,EMR,22531,10364,12167,14202,8329,ITH,ITH5,8,Emilia-Romagna
2021-02-26,SIC,12211,5969,6242,10527,1684,ITG,ITG1,19,Sicilia
2021-03-18,BAS,1348,562,786,24,1324,ITF,ITF5,17,Basilicata
2021-04-23,LOM,73324,33261,40063,56816,16508,ITC,ITC4,3,Lombardia
2021-05-19,VEN,31753,14576,17177,16329,15424,ITH,ITH3,5,Veneto
2021-01-14,ABR,530,189,341,530,0,ITF,ITF1,13,Abruzzo
2021-05-17,LAZ,43731,19967,23764,35315,8416,ITI,ITI4,12,Lazio
2021-01-19,SAR,747,270,477,692,55,ITG,ITG2,20,Sardegna
2021-01-26,MAR,2016,746,1270,92,1924,ITI,ITI3,11,Marche
2021-03-16,UMB,3538,1454,2084,1911,1627,ITI,ITI2,10,Umbria
2021-04-09,UMB,6788,3160,3628,6572,216,ITI,ITI2,10,Umbria
2021-04-14,FVG,7215,3118,4097,5503,1712,ITH,ITH4,6,Friuli-Venezia Giulia
2021-04-21,ABR,6384,3100,3284,4710,1674,ITF,ITF1,13,Abruzzo
2020-12-27,LIG,135,56,79,135,0,ITC,ITC3,7,Liguria
2021-01-16,VEN,4606,1541,3065,4606,0,ITH,ITH3,5,Veneto
2021-01-28,VDA,290,123,167,56,234,ITC,ITC2,2,Valle d'Aosta / Vallée d'Aoste
2021-03-11,MOL,1463,636,827,1457,6,ITF,ITF2,14,Molise
2021-04-22,MAR,10792,4930,5862,9214,1578,ITI,ITI3,11,Marche
2020-12-31,MAR,385,180,205,385,0,ITI,ITI3,11,Marche
2021-03-22,PAT,2305,973,1332,1430,875,ITH,ITH2,4,Provincia Autonoma Trento
2021-04-27,LOM,85866,39933,45933,69347,16519,ITC,ITC4,3,Lombardia
2021-05-11,PAB,2842,1334,1508,1320,1522,ITH,ITH1,4,Provincia Autonoma Bolzano / Bozen
2021-05-17,BAS,5535,2729,2806,3409,2126,ITF,ITF5,17,Basilicata
2021-01-17,SIC,1302,589,713,1245,57,ITG,ITG1,19,Sicilia
2021-01-25,MOL,319,130,189,3,316,ITF,ITF2,14,Molise
2021-03-04,MAR,6488,2870,3618,5095,1393,ITI,ITI3,11,Marche
2021-05-18,PIE,31659,14547,17112,19268,12391,ITC,ITC1,1,Piemonte
2021-02-28,BAS,804,343,461,775,29,ITF,ITF5,17,Basilicata
2021-03-17,CAL,3793,1686,2107,2097,1696,ITF,ITF6,18,Calabria
2021-03-25,PAB,2141,1059,1082,1698,443,ITH,ITH1,4,Provincia Autonoma Bolzano / Bozen
2021-05-06,BAS,5034,2429,2605,3473,1561,ITF,ITF5,17,Basilicata
2021-05-15,CAM,62578,29003,33575,43913,18665,ITF,ITF3,15,Campania
2021-02-14,MAR,738,301,437,738,0,ITI,ITI3,11,Marche
2020-12-30,SIC,174,102,72,174,0,ITG,ITG1,19,Sicilia
2021-01-06,TOS,4520,1460,3060,4520,0,ITI,ITI1,9,Toscana
2021-01-18,CAL,1259,566,693,1043,216,ITF,ITF6,18,Calabria
2021-02-23,LOM,11773,4792,6981,11465,308,ITC,ITC4,3,Lombardia
2021-03-31,PAT,2561,983,1578,1704,857,ITH,ITH2,4,Provincia Autonoma Trento
2021-04-29,BAS,4832,2386,2446,4410,422,ITF,ITF5,17,Basilicata
2021-04-30,SIC,35170,16438,18732,23972,11198,ITG,ITG1,19,Sicilia
2021-05-10,EMR,33406,15886,17520,26184,7222,ITH,ITH5,8,Emilia-Romagna
2021-02-11,LAZ,6979,2993,3986,6467,512,ITI,ITI4,12,Lazio
2021-02-11,FVG,1930,664,1266,1738,192,ITH,ITH4,6,Friuli-Venezia Giulia
2021-02-28,LAZ,10249,4007,6242,9735,514,ITI,ITI4,12,Lazio
2021-02-07,UMB,54,17,37,1,53,ITI,ITI2,10,Umbria
2021-03-24,PAB,2040,977,1063,2027,13,ITH,ITH1,4,Provincia Autonoma Bolzano / Bozen
2021-01-13,LOM,26378,8053,18325,26378,0,ITC,ITC4,3,Lombardia
2021-02-22,PIE,8479,3471,5008,7889,590,ITC,ITC1,1,Piemonte
2020-12-29,SIC,236,146,90,236,0,ITG,ITG1,19,Sicilia
2021-03-20,VEN,12942,5340,7602,10847,2095,ITH,ITH3,5,Veneto
2021-05-16,LAZ,50694,24407,26287,37226,13468,ITI,ITI4,12,Lazio
2021-02-21,BAS,284,113,171,284,0,ITF,ITF5,17,Basilicata
2021-05-18,ABR,12118,5665,6453,7735,4383,ITF,ITF1,13,Abruzzo
2020-12-28,LIG,80,30,50,80,0,ITC,ITC3,7,Liguria
2021-01-28,CAL,2232,1108,1124,82,2150,ITF,ITF6,18,Calabria
2021-02-25,BAS,1787,736,1051,1741,46,ITF,ITF5,17,Basilicata
2021-03-06,CAL,7945,4051,3894,7190,755,ITF,ITF6,18,Calabria
2021-04-10,PUG,30705,13021,17684,26483,4222,ITF,ITF4,16,Puglia
2021-05-01,PAB,2104,1067,1037,1944,160,ITH,ITH1,4,Provincia Autonoma Bolzano / Bozen
2021-05-16,TOS,26622,12858,13764,24169,2453,ITI,ITI1,9,Toscana
2021-02-05,PUG,5634,2273,3361,1332,4302,ITF,ITF4,16,Puglia
2021-01-05,PAB,830,286,544,830,0,ITH,ITH1,4,Provincia Autonoma Bolzano / Bozen
2021-01-29,UMB,1232,348,884,79,1153,ITI,ITI2,10,Umbria
2021-02-12,MOL,330,149,181,208,122,ITF,ITF2,14,Molise
2021-05-21,EMR,36524,16399,20125,20266,16258,ITH,ITH5,8,Emilia-Romagna
2021-02-13,VDA,216,196,20,215,1,ITC,ITC2,2,Valle d'Aosta / Vallée d'Aoste
2021-03-22,PUG,9344,4551,4793,3700,5644,ITF,ITF4,16,Puglia
2021-04-26,SIC,21921,10376,11545,13782,8139,ITG,ITG1,19,Sicilia
2021-05-19,MAR,11471,5272,6199,8562,2909,ITI,ITI3,11,Marche
2021-01-17,PAT,251,195,56,251,0,ITH,ITH2,4,Provincia Autonoma Trento
2021-04-25,VEN,18303,8144,10159,13469,4834,ITH,ITH3,5,Veneto
2021-01-21,PAB,952,442,510,139,813,ITH,ITH1,4,Provincia Autonoma Bolzano / Bozen
2021-03-29,TOS,9377,4579,4798,9053,324,ITI,ITI1,9,Toscana
2021-04-07,CAL,6361,2875,3486,3650,2711,ITF,ITF6,18,Calabria
2020-12-27,PAB,144,65,79,144,0,ITH,ITH1,4,Provincia Autonoma Bolzano / Bozen
2021-01-12,TOS,3581,1398,2183,3581,0,ITI,ITI1,9,Toscana
2021-01-27,VDA,151,71,80,79,72,ITC,ITC2,2,Valle d'Aosta / Vallée d'Aoste
2021-02-14,VDA,48,16,32,1,47,ITC,ITC2,2,Valle d'Aosta / Vallée d'Aoste
2021-03-20,FVG,3340,1351,1989,1249,2091,ITH,ITH4,6,Friuli-Venezia Giulia
2021-05-02,MOL,1878,925,953,575,1303,ITF,ITF2,14,Molise
2021-05-06,PIE,33103,15609,17494,19713,13390,ITC,ITC1,1,Piemonte
2021-02-06,PUG,4545,1927,2618,1589,2956,ITF,ITF4,16,Puglia
2021-02-24,VEN,8613,3678,4935,8128,485,ITH,ITH3,5,Veneto
2021-04-16,PUG,35726,16785,18941,32444,3282,ITF,ITF4,16,Puglia
2021-05-11,LIG,13656,6171,7485,7066,6590,ITC,ITC3,7,Liguria
2021-01-05,EMR,9347,3167,6180,9347,0,ITH,ITH5,8,Emilia-Romagna
2021-02-04,PAT,973,304,669,420,553,ITH,ITH2,4,Provincia Autonoma Trento
2021-02-07,TOS,2806,953,1853,885,1921,ITI,ITI1,9,Toscana
2021-01-01,LAZ,3554,1382,2172,3554,0,ITI,ITI4,12,Lazio
2021-03-06,SIC,12916,5167,7749,10012,2904,ITG,ITG1,19,Sicilia
2021-05-12,CAL,16215,7840,8375,10882,5333,ITF,ITF6,18,Calabria
2021-02-09,SIC,4411,1823,2588,3356,1055,ITG,ITG1,19,Sicilia
2021-02-07,SAR,1116,394,722,228,888,ITG,ITG2,20,Sardegna
2021-03-12,LAZ,22886,10124,12762,16573,6313,ITI,ITI4,12,Lazio
2021-03-22,SIC,16817,7915,8902,11274,5543,ITG,ITG1,19,Sicilia
2021-01-01,TOS,2369,787,1582,2369,0,ITI,ITI1,9,Toscana
2021-03-26,LAZ,28224,12251,15973,21381,6843,ITI,ITI4,12,Lazio
2021-04-06,VEN,28863,13267,15596,23789,5074,ITH,ITH3,5,Veneto
2021-05-14,VEN,45923,21835,24088,25488,20435,ITH,ITH3,5,Veneto
2021-01-05,TOS,5249,1755,3494,5249,0,ITI,ITI1,9,Toscana
2021-02-03,VDA,351,114,237,14,337,ITC,ITC2,2,Valle d'Aosta / Vallée d'Aoste
2021-04-04,LAZ,17463,8036,9427,12197,5266,ITI,ITI4,12,Lazio
2021-04-10,SIC,20661,10084,10577,11619,9042,ITG,ITG1,19,Sicilia
2021-05-05,PUG,38656,16885,21771,24547,14109,ITF,ITF4,16,Puglia
2021-01-26,VDA,139,48,91,0,139,ITC,ITC2,2,Valle d'Aosta / Vallée d'Aoste
2021-04-01,VEN,25031,10981,14050,18646,6385,ITH,ITH3,5,Veneto
2020-12-31,SAR,32,16,16,32,0,ITG,ITG2,20,Sardegna
2021-02-13,CAM,5507,2550,2957,5290,217,ITF,ITF3,15,Campania
2021-02-26,CAL,3061,1631,1430,2609,452,ITF,ITF6,18,Calabria
2021-03-23,LIG,9036,4082,4954,5827,3209,ITC,ITC3,7,Liguria
2021-05-06,ABR,12972,6026,6946,7965,5007,ITF,ITF1,13,Abruzzo
2021-01-12,LAZ,5392,1975,3417,5392,0,ITI,ITI4,12,Lazio
2021-01-24,LIG,756,237,519,113,643,ITC,ITC3,7,Liguria
2021-02-01,SAR,1524,605,919,225,1299,ITG,ITG2,20,Sardegna
2021-03-12,UMB,2652,1039,1613,2154,498,ITI,ITI2,10,Umbria
2021-01-04,SAR,592,217,375,592,0,ITG,ITG2,20,Sardegna
2021-01-23,LAZ,7210,2867,4343,581,6629,ITI,ITI4,12,Lazio
2021-02-17,FVG,2353,999,1354,1873,480,ITH,ITH4,6,Friuli-Venezia Giulia
2021-02-22,BAS,1790,773,1017,1737,53,ITF,ITF5,17,Basilicata
2021-03-24,CAM,17618,8082,9536,14661,2957,ITF,ITF3,15,Campania
2021-03-28,VEN,31246,13584,17662,27612,3634,ITH,ITH3,5,Veneto
2021-05-01,LIG,7134,3255,3879,1332,5802,ITC,ITC3,7,Liguria
2021-02-12,VDA,263,96,167,217,46,ITC,ITC2,2,Valle d'Aosta / Vallée d'Aoste
2021-03-02,FVG,4220,1519,2701,2721,1499,ITH,ITH4,6,Friuli-Venezia Giulia
2021-05-17,PAT,4267,2113,2154,3928,339,ITH,ITH2,4,Provincia Autonoma Trento
2021-01-24,CAM,4128,2123,2005,383,3745,ITF,ITF3,15,Campania
2021-04-16,PAT,2833,1342,1491,2688,145,ITH,ITH2,4,Provincia Autonoma Trento
2021-01-02,EMR,2353,905,1448,2353,0,ITH,ITH5,8,Emilia-Romagna
2021-05-07,MOL,2641,1226,1415,2044,597,ITF,ITF2,14,Molise
2021-01-17,PUG,1308,590,718,1239,69,ITF,ITF4,16,Puglia
2021-03-17,SIC,15161,7459,7702,9249,5912,ITG,ITG1,19,Sicilia
2021-03-25,CAM,19990,9335,10655,16487,3503,ITF,ITF3,15,Campania
2021-04-25,LOM,51391,23574,27817,46717,4674,ITC,ITC4,3,Lombardia
2021-03-08,MOL,1379,522,857,1239,140,ITF,ITF2,14,Molise
2021-04-11,MOL,1151,581,570,1138,13,ITF,ITF2,14,Molise
2021-04-29,ABR,12667,5849,6818,9572,3095,ITF,ITF1,13,Abruzzo
2021-05-09,EMR,24170,11575,12595,17219,6951,ITH,ITH5,8,Emilia-Romagna
2021-01-07,MOL,598,209,389,598,0,ITF,ITF2,14,Molise
2021-01-23,FVG,816,324,492,4,812,ITH,ITH4,6,Friuli-Venezia Giulia
2021-02-27,PUG,14201,4806,9395,12977,1224,ITF,ITF4,16,Puglia
2021-01-08,TOS,5946,1642,4304,5946,0,ITI,ITI1,9,Toscana
2021-01-20,EMR,1323,270,1053,1322,1,ITH,ITH5,8,Emilia-Romagna
2021-02-04,PUG,5898,2357,3541,1167,4731,ITF,ITF4,16,Puglia
2021-03-07,FVG,2538,926,1612,2537,1,ITH,ITH4,6,Friuli-Venezia Giulia
2021-03-19,VEN,13790,5668,8122,7697,6093,ITH,ITH3,5,Veneto
2021-05-15,VDA,1064,614,450,379,685,ITC,ITC2,2,Valle d'Aosta / Vallée d'Aoste
2021-03-25,LIG,9596,4081,5515,6203,3393,ITC,ITC3,7,Liguria
2021-04-15,MAR,10376,4674,5702,9811,565,ITI,ITI3,11,Marche
2021-01-16,LAZ,5640,2279,3361,5640,0,ITI,ITI4,12,Lazio
2021-02-21,PIE,5089,2082,3007,4987,102,ITC,ITC1,1,Piemonte
2021-02-22,SIC,8013,4146,3867,7522,491,ITG,ITG1,19,Sicilia
2021-02-05,SIC,7100,3155,3945,2129,4971,ITG,ITG1,19,Sicilia
2021-02-08,TOS,4097,1360,2737,3638,459,ITI,ITI1,9,Toscana
2021-02-13,MAR,1062,453,609,1010,52,ITI,ITI3,11,Marche
2021-03-09,VDA,206,96,110,174,32,ITC,ITC2,2,Valle d'Aosta / Vallée d'Aoste
2021-04-29,PIE,48236,21826,26410,35653,12583,ITC,ITC1,1,Piemonte
2021-05-12,LAZ,47350,21453,25897,30865,16485,ITI,ITI4,12,Lazio
2021-01-10,LOM,10518,3957,6561,10518,0,ITC,ITC4,3,Lombardia
2021-01-25,VDA,147,65,82,0,147,ITC,ITC2,2,Valle d'Aosta / Vallée d'Aoste
2021-01-30,TOS,4622,1622,3000,198,4424,ITI,ITI1,9,Toscana
2021-03-24,LIG,8943,3835,5108,5655,3288,ITC,ITC3,7,Liguria
2021-04-09,FVG,7762,3528,4234,6518,1244,ITH,ITH4,6,Friuli-Venezia Giulia
2021-05-22,MOL,1227,665,562,1145,82,ITF,ITF2,14,Molise
2021-01-11,MOL,557,194,363,557,0,ITF,ITF2,14,Molise
2021-04-12,VDA,485,186,299,322,163,ITC,ITC2,2,Valle d'Aosta / Vallée d'Aoste
2021-05-13,SIC,47223,22172,25051,30650,16573,ITG,ITG1,19,Sicilia
2021-05-21,PAB,6809,3719,3090,5038,1771,ITH,ITH1,4,Provincia Autonoma Bolzano / Bozen
2021-02-25,ABR,3042,1330,1712,2514,528,ITF,ITF1,13,Abruzzo
2021-03-14,LOM,14876,5349,9527,11590,3286,ITC,ITC4,3,Lombardia
2021-04-26,VEN,20684,9440,11244,15534,5150,ITH,ITH3,5,Veneto
2021-05-23,VDA,599,261,338,272,327,ITC,ITC2,2,Valle d'Aosta / Vallée d'Aoste
2021-02-10,ABR,947,312,635,503,444,ITF,ITF1,13,Abruzzo
2021-05-22,FVG,10176,4535,5641,6452,3724,ITH,ITH4,6,Friuli-Venezia Giulia
2021-01-18,SAR,904,326,578,780,124,ITG,ITG2,20,Sardegna
2021-01-26,ABR,1542,567,975,30,1512,ITF,ITF1,13,Abruzzo
2021-02-08,BAS,557,193,364,151,406,ITF,ITF5,17,Basilicata
2021-02-16,FVG,2516,1135,1381,2400,116,ITH,ITH4,6,Friuli-Venezia Giulia
2021-02-28,PIE,10814,4059,6755,10574,240,ITC,ITC1,1,Piemonte
2021-03-03,LOM,26916,11495,15421,19643,7273,ITC,ITC4,3,Lombardia
2021-03-07,LIG,1857,1084,773,1556,301,ITC,ITC3,7,Liguria
2021-05-17,PUG,31881,14603,17278,20345,11536,ITF,ITF4,16,Puglia
2021-01-17,VEN,1933,781,1152,1584,349,ITH,ITH3,5,Veneto
2021-03-11,EMR,17219,7114,10105,11368,5851,ITH,ITH5,8,Emilia-Romagna
2021-03-23,CAM,15336,7055,8281,12823,2513,ITF,ITF3,15,Campania
2021-04-22,MOL,1835,858,977,1064,771,ITF,ITF2,14,Molise
2021-03-09,LOM,33234,12847,20387,25811,7423,ITC,ITC4,3,Lombardia
2021-03-24,UMB,4072,1760,2312,2749,1323,ITI,ITI2,10,Umbria
2021-05-03,ABR,11105,5239,5866,7256,3849,ITF,ITF1,13,Abruzzo
2021-01-16,MAR,2005,723,1282,2005,0,ITI,ITI3,11,Marche
2021-03-04,LIG,4738,2118,2620,3891,847,ITC,ITC3,7,Liguria
2021-04-03,PAT,1138,471,667,971,167,ITH,ITH2,4,Provincia Autonoma Trento
2021-04-12,LOM,47222,20568,26654,32892,14330,ITC,ITC4,3,Lombardia
2021-05-20,VEN,42995,20439,22556,19292,23703,ITH,ITH3,5,Veneto
2021-01-25,LOM,7024,2372,4652,489,6535,ITC,ITC4,3,Lombardia
2021-02-12,LOM,13946,4355,9591,9028,4918,ITC,ITC4,3,Lombardia
2021-01-02,CAM,3673,1962,1711,3673,0,ITF,ITF3,15,Campania
2021-01-30,PAB,498,245,253,4,494,ITH,ITH1,4,Provincia Autonoma Bolzano / Bozen
2021-05-15,LOM,80167,38493,41674,47270,32897,ITC,ITC4,3,Lombardia
2021-01-03,CAL,6,3,3,6,0,ITF,ITF6,18,Calabria
2021-01-07,EMR,10221,3386,6835,10221,0,ITH,ITH5,8,Emilia-Romagna
2021-01-16,PAT,319,148,171,319,0,ITH,ITH2,4,Provincia Autonoma Trento
2021-03-14,ABR,1883,731,1152,1216,667,ITF,ITF1,13,Abruzzo
2021-02-14,CAL,369,144,225,339,30,ITF,ITF6,18,Calabria
2021-02-14,LIG,233,122,111,233,0,ITC,ITC3,7,Liguria
2021-03-23,UMB,3797,1685,2112,2168,1629,ITI,ITI2,10,Umbria
2021-05-04,UMB,5529,2542,2987,2410,3119,ITI,ITI2,10,Umbria
2021-01-24,UMB,258,106,152,1,257,ITI,ITI2,10,Umbria
2021-04-25,ABR,9067,4620,4447,8258,809,ITF,ITF1,13,Abruzzo
2021-01-20,CAM,1257,650,607,1257,0,ITF,ITF3,15,Campania
2021-01-27,LOM,8045,2677,5368,821,7224,ITC,ITC4,3,Lombardia
2021-02-22,PAT,745,259,486,661,84,ITH,ITH2,4,Provincia Autonoma Trento
2021-03-28,SIC,10931,5136,5795,6920,4011,ITG,ITG1,19,Sicilia
2021-04-07,EMR,25743,11697,14046,19740,6003,ITH,ITH5,8,Emilia-Romagna
2021-05-03,VDA,839,400,439,488,351,ITC,ITC2,2,Valle d'Aosta / Vallée d'Aoste
2021-05-07,VDA,564,245,319,533,31,ITC,ITC2,2,Valle d'Aosta / Vallée d'Aoste
2021-05-09,PAB,4233,2404,1829,3080,1153,ITH,ITH1,4,Provincia Autonoma Bolzano / Bozen
2021-01-30,UMB,1590,490,1100,44,1546,ITI,ITI2,10,Umbria
2021-05-22,PUG,31035,14265,16770,21925,9110,ITF,ITF4,16,Puglia
2021-01-21,SAR,126,60,66,94,32,ITG,ITG2,20,Sardegna
2021-03-19,SIC,16518,8114,8404,10787,5731,ITG,ITG1,19,Sicilia
2021-04-27,LIG,14740,6678,8062,7161,7579,ITC,ITC3,7,Liguria
2021-05-17,MOL,2208,1083,1125,1727,481,ITF,ITF2,14,Molise
2021-01-09,FVG,2513,841,1672,2513,0,ITH,ITH4,6,Friuli-Venezia Giulia
2021-02-06,LOM,15255,5529,9726,1068,14187,ITC,ITC4,3,Lombardia
2021-02-18,PAT,1205,426,779,1143,62,ITH,ITH2,4,Provincia Autonoma Trento
2021-03-08,VDA,482,231,251,237,245,ITC,ITC2,2,Valle d'Aosta / Vallée d'Aoste
2021-03-25,UMB,3904,1699,2205,2840,1064,ITI,ITI2,10,Umbria
2021-05-04,LAZ,39671,18246,21425,26248,13423,ITI,ITI4,12,Lazio
2021-05-11,LAZ,47854,21940,25914,31498,16356,ITI,ITI4,12,Lazio
2021-03-29,PIE,15160,6384,8776,8547,6613,ITC,ITC1,1,Piemonte
2021-05-02,PAT,3512,1955,1557,3474,38,ITH,ITH2,4,Provincia Autonoma Trento
2021-05-19,PAT,5071,2445,2626,3837,1234,ITH,ITH2,4,Provincia Autonoma Trento
2021-02-23,EMR,8214,3218,4996,7828,386,ITH,ITH5,8,Emilia-Romagna
2021-03-14,PAB,758,336,422,25,733,ITH,ITH1,4,Provincia Autonoma Bolzano / Bozen
2021-05-11,UMB,6216,2825,3391,4017,2199,ITI,ITI2,10,Umbria
2021-01-10,ABR,1139,409,730,1139,0,ITF,ITF1,13,Abruzzo
2021-01-29,TOS,6136,1698,4438,302,5834,ITI,ITI1,9,Toscana
2021-05-09,UMB,5764,2757,3007,5373,391,ITI,ITI2,10,Umbria
2021-01-27,CAM,7738,3820,3918,162,7576,ITF,ITF3,15,Campania
2021-03-09,CAM,13877,6636,7241,10095,3782,ITF,ITF3,15,Campania
2021-01-15,LAZ,6563,2700,3863,6563,0,ITI,ITI4,12,Lazio
2021-02-11,MOL,293,133,160,257,36,ITF,ITF2,14,Molise
2021-02-20,ABR,4777,1842,2935,4701,76,ITF,ITF1,13,Abruzzo
2021-03-16,FVG,3153,1287,1866,1073,2080,ITH,ITH4,6,Friuli-Venezia Giulia
2021-04-03,PUG,10486,4601,5885,6938,3548,ITF,ITF4,16,Puglia
2021-04-16,LOM,53586,23888,29698,39272,14314,ITC,ITC4,3,Lombardia
2021-04-19,CAM,30710,14816,15894,19143,11567,ITF,ITF3,15,Campania
2021-05-01,UMB,5372,2639,2733,2145,3227,ITI,ITI2,10,Umbria
2021-02-12,VEN,4312,1446,2866,3740,572,ITH,ITH3,5,Veneto
2021-03-12,MAR,4641,1972,2669,3403,1238,ITI,ITI3,11,Marche
2021-04-12,VEN,14897,6332,8565,6682,8215,ITH,ITH3,5,Veneto
2021-05-23,CAM,42791,20962,21829,26058,16733,ITF,ITF3,15,Campania
2021-05-14,TOS,33095,15308,17787,20541,12554,ITI,ITI1,9,Toscana
2021-05-15,FVG,12548,6052,6496,7872,4676,ITH,ITH4,6,Friuli-Venezia Giulia
2021-01-08,CAL,2132,1020,1112,2132,0,ITF,ITF6,18,Calabria
2021-01-26,LIG,2484,803,1681,13,2471,ITC,ITC3,7,Liguria
2021-02-01,VDA,404,127,277,87,317,ITC,ITC2,2,Valle d'Aosta / Vallée d'Aoste
2021-03-09,LIG,5932,2754,3178,4503,1429,ITC,ITC3,7,Liguria
2021-01-12,PIE,10050,3406,6644,10050,0,ITC,ITC1,1,Piemonte
2021-01-24,PAB,12,10,2,0,12,ITH,ITH1,4,Provincia Autonoma Bolzano / Bozen
2021-01-25,VEN,6468,2075,4393,160,6308,ITH,ITH3,5,Veneto
2021-03-01,MOL,661,274,387,447,214,ITF,ITF2,14,Molise
2021-03-31,VDA,555,302,253,529,26,ITC,ITC2,2,Valle d'Aosta / Vallée d'Aoste
2021-04-21,PAB,3009,1467,1542,2161,848,ITH,ITH1,4,Provincia Autonoma Bolzano / Bozen
2021-05-23,LIG,1712,830,882,799,913,ITC,ITC3,7,Liguria
2021-01-07,VDA,275,111,164,275,0,ITC,ITC2,2,Valle d'Aosta / Vallée d'Aoste
2021-02-18,PUG,4378,1846,2532,3774,604,ITF,ITF4,16,Puglia
2021-03-27,CAL,8309,3773,4536,4451,3858,ITF,ITF6,18,Calabria
2021-04-30,VEN,49899,23435,26464,34240,15659,ITH,ITH3,5,Veneto
2021-02-04,MOL,758,295,463,77,681,ITF,ITF2,14,Molise
2021-03-15,BAS,2351,983,1368,521,1830,ITF,ITF5,17,Basilicata
2021-01-10,PIE,5214,2275,2939,5214,0,ITC,ITC1,1,Piemonte
2021-02-09,FVG,1841,554,1287,1555,286,ITH,ITH4,6,Friuli-Venezia Giulia
2021-03-18,EMR,13672,5806,7866,5673,7999,ITH,ITH5,8,Emilia-Romagna
2021-03-21,PIE,10712,4736,5976,4185,6527,ITC,ITC1,1,Piemonte
2021-05-12,MAR,10422,4684,5738,4921,5501,ITI,ITI3,11,Marche
2021-03-30,VDA,402,223,179,382,20,ITC,ITC2,2,Valle d'Aosta / Vallée d'Aoste
2021-05-05,LOM,87667,41806,45861,72530,15137,ITC,ITC4,3,Lombardia
2021-01-06,SIC,6478,3408,3070,6478,0,ITG,ITG1,19,Sicilia
2021-03-30,SAR,8632,3456,5176,6359,2273,ITG,ITG2,20,Sardegna
2021-01-27,LIG,1744,603,1141,141,1603,ITC,ITC3,7,Liguria
2021-04-15,SIC,21345,10385,10960,11788,9557,ITG,ITG1,19,Sicilia
2021-04-22,CAL,9352,4665,4687,6666,2686,ITF,ITF6,18,Calabria
2021-04-05,CAM,11636,5543,6093,9214,2422,ITF,ITF3,15,Campania
2021-04-19,LIG,12812,5617,7195,9003,3809,ITC,ITC3,7,Liguria
2021-04-20,TOS,18149,8106,10043,12592,5557,ITI,ITI1,9,Toscana
2021-02-21,LAZ,6986,3178,3808,6525,461,ITI,ITI4,12,Lazio
2021-03-26,MAR,6331,2606,3725,3523,2808,ITI,ITI3,11,Marche
2021-05-02,PUG,21143,9586,11557,13894,7249,ITF,ITF4,16,Puglia
2021-05-19,PUG,25293,11988,13305,19168,6125,ITF,ITF4,16,Puglia
2021-02-17,PAB,156,51,105,139,17,ITH,ITH1,4,Provincia Autonoma Bolzano / Bozen
2021-03-01,SIC,12964,6121,6843,11309,1655,ITG,ITG1,19,Sicilia
2021-04-01,LAZ,28402,13047,15355,21262,7140,ITI,ITI4,12,Lazio
2021-04-18,BAS,3720,1847,1873,2353,1367,ITF,ITF5,17,Basilicata
2021-05-15,LIG,7100,3157,3943,4298,2802,ITC,ITC3,7,Liguria
2021-01-26,CAL,1802,858,944,278,1524,ITF,ITF6,18,Calabria
2021-05-14,LAZ,50654,23117,27537,32508,18146,ITI,ITI4,12,Lazio
2021-03-08,MAR,6264,2744,3520,5262,1002,ITI,ITI3,11,Marche
2021-04-07,MOL,1687,847,840,1412,275,ITF,ITF2,14,Molise
2021-04-27,PIE,22542,10195,12347,17429,5113,ITC,ITC1,1,Piemonte
2021-02-28,PAT,242,121,121,242,0,ITH,ITH2,4,Provincia Autonoma Trento
2021-03-05,VEN,13284,4978,8306,9623,3661,ITH,ITH3,5,Veneto
2021-03-12,TOS,16521,6220,10301,12993,3528,ITI,ITI1,9,Toscana
2021-03-13,MOL,1189,594,595,200,989,ITF,ITF2,14,Molise
2021-05-04,SAR,9527,4381,5146,7674,1853,ITG,ITG2,20,Sardegna
2021-03-21,TOS,3231,1573,1658,1798,1433,ITI,ITI1,9,Toscana
2021-02-01,MAR,1362,479,883,98,1264,ITI,ITI3,11,Marche
2021-02-15,LAZ,8025,3540,4485,7394,631,ITI,ITI4,12,Lazio
2021-05-09,TOS,22482,9737,12745,9636,12846,ITI,ITI1,9,Toscana
2021-05-12,MOL,2834,1288,1546,2749,85,ITF,ITF2,14,Molise
2021-05-19,SIC,41368,19900,21468,27270,14098,ITG,ITG1,19,Sicilia
2021-03-14,LIG,1658,752,906,1054,604,ITC,ITC3,7,Liguria
2021-04-15,PUG,32313,15065,17248,28816,3497,ITF,ITF4,16,Puglia
2021-03-31,MOL,2193,919,1274,1374,819,ITF,ITF2,14,Molise
2021-05-02,VEN,37154,17224,19930,26826,10328,ITH,ITH3,5,Veneto
2021-01-12,SIC,4545,2235,2310,4545,0,ITG,ITG1,19,Sicilia
2021-02-23,PAB,769,324,445,763,6,ITH,ITH1,4,Provincia Autonoma Bolzano / Bozen
2021-03-29,BAS,2435,881,1554,2149,286,ITF,ITF5,17,Basilicata
2021-03-02,MOL,667,383,284,509,158,ITF,ITF2,14,Molise
2021-03-28,PAT,748,292,456,745,3,ITH,ITH2,4,Provincia Autonoma Trento
2021-04-13,MAR,9838,4259,5579,9605,233,ITI,ITI3,11,Marche
2021-05-08,CAM,56330,27094,29236,40525,15805,ITF,ITF3,15,Campania
2021-01-21,LAZ,5592,2340,3252,540,5052,ITI,ITI4,12,Lazio
2021-01-31,CAM,8067,3711,4356,23,8044,ITF,ITF3,15,Campania
2021-02-13,LOM,6416,2443,3973,4939,1477,ITC,ITC4,3,Lombardia
2021-04-23,ABR,7368,3382,3986,5066,2302,ITF,ITF1,13,Abruzzo
2021-01-21,UMB,610,202,408,341,269,ITI,ITI2,10,Umbria
2021-02-03,SAR,1119,419,700,426,693,ITG,ITG2,20,Sardegna
2021-01-30,SAR,3862,1392,2470,362,3500,ITG,ITG2,20,Sardegna
2021-03-13,FVG,2933,1119,1814,1662,1271,ITH,ITH4,6,Friuli-Venezia Giulia
2021-05-16,MAR,10897,4957,5940,6670,4227,ITI,ITI3,11,Marche
2021-05-03,MAR,10192,4602,5590,4786,5406,ITI,ITI3,11,Marche
2021-01-05,SIC,10535,5162,5373,10535,0,ITG,ITG1,19,Sicilia
2021-02-15,FVG,2453,911,1542,2202,251,ITH,ITH4,6,Friuli-Venezia Giulia
2021-03-10,PUG,14392,6239,8153,11274,3118,ITF,ITF4,16,Puglia
2021-03-26,MOL,2574,1045,1529,1932,642,ITF,ITF2,14,Molise
2021-04-06,PAT,2258,949,1309,1493,765,ITH,ITH2,4,Provincia Autonoma Trento
2021-01-28,EMR,10244,3336,6908,349,9895,ITH,ITH5,8,Emilia-Romagna
2021-04-08,MOL,1754,900,854,1553,201,ITF,ITF2,14,Molise
2020-12-31,SIC,878,470,408,878,0,ITG,ITG1,19,Sicilia
2021-01-29,MAR,1991,730,1261,167,1824,ITI,ITI3,11,Marche
2021-04-20,PAB,1559,782,777,1558,1,ITH,ITH1,4,Provincia Autonoma Bolzano / Bozen
2021-04-23,PIE,27422,12589,14833,20663,6759,ITC,ITC1,1,Piemonte
2021-05-16,VEN,28377,13997,14380,21315,7062,ITH,ITH3,5,Veneto
2021-01-08,SIC,8333,3866,4467,8333,0,ITG,ITG1,19,Sicilia
2021-03-25,FVG,5309,2261,3048,3176,2133,ITH,ITH4,6,Friuli-Venezia Giulia
2021-04-03,BAS,1807,749,1058,1472,335,ITF,ITF5,17,Basilicata
2021-02-02,LAZ,5908,2212,3696,636,5272,ITI,ITI4,12,Lazio
2021-04-14,PIE,27699,12557,15142,23178,4521,ITC,ITC1,1,Piemonte
2021-03-03,EMR,15820,5245,10575,13347,2473,ITH,ITH5,8,Emilia-Romagna
2021-04-04,MOL,253,141,112,238,15,ITF,ITF2,14,Molise
2021-04-19,PAB,1871,858,1013,1689,182,ITH,ITH1,4,Provincia Autonoma Bolzano / Bozen
2021-04-21,LIG,14246,6432,7814,8923,5323,ITC,ITC3,7,Liguria
2021-05-08,LIG,7527,3330,4197,2322,5205,ITC,ITC3,7,Liguria
2021-03-08,VEN,13546,6193,7353,9477,4069,ITH,ITH3,5,Veneto
2021-02-01,CAM,3985,1813,2172,110,3875,ITF,ITF3,15,Campania
2021-04-13,CAL,6485,3194,3291,5233,1252,ITF,ITF6,18,Calabria
2021-04-26,PAT,2646,1244,1402,2552,94,ITH,ITH2,4,Provincia Autonoma Trento
2021-02-02,BAS,367,143,224,175,192,ITF,ITF5,17,Basilicata
2021-05-21,LAZ,48630,22785,25845,36273,12357,ITI,ITI4,12,Lazio
2020-12-27,LAZ,273,131,142,273,0,ITI,ITI4,12,Lazio
2020-12-27,UMB,86,45,41,86,0,ITI,ITI2,10,Umbria
2021-01-11,VEN,7238,2101,5137,7238,0,ITH,ITH3,5,Veneto
2021-01-15,VEN,5864,1819,4045,5864,0,ITH,ITH3,5,Veneto
2021-03-28,PUG,3524,1650,1874,1199,2325,ITF,ITF4,16,Puglia
2021-04-27,ABR,9084,4370,4714,6616,2468,ITF,ITF1,13,Abruzzo
2021-03-19,PAT,2423,915,1508,1571,852,ITH,ITH2,4,Provincia Autonoma Trento
2021-04-15,VEN,20808,8583,12225,10005,10803,ITH,ITH3,5,Veneto
2021-05-08,MAR,12269,5476,6793,5021,7248,ITI,ITI3,11,Marche
2021-04-11,VEN,20982,8866,12116,14675,6307,ITH,ITH3,5,Veneto
2021-04-17,PUG,39713,18799,20914,36148,3565,ITF,ITF4,16,Puglia
2021-05-10,PAB,3018,1300,1718,1413,1605,ITH,ITH1,4,Provincia Autonoma Bolzano / Bozen
2021-05-18,BAS,5892,2852,3040,3403,2489,ITF,ITF5,17,Basilicata
2021-05-21,UMB,8854,3600,5254,4062,4792,ITI,ITI2,10,Umbria
2021-01-03,SAR,90,36,54,90,0,ITG,ITG2,20,Sardegna
2021-03-15,PIE,10648,4157,6491,5029,5619,ITC,ITC1,1,Piemonte
2021-04-03,LAZ,24680,11092,13588,17981,6699,ITI,ITI4,12,Lazio
2021-05-10,UMB,5952,2782,3170,3800,2152,ITI,ITI2,10,Umbria
2021-05-22,VEN,33397,16066,17331,12652,20745,ITH,ITH3,5,Veneto
2021-04-06,PUG,13472,5978,7494,6825,6647,ITF,ITF4,16,Puglia
2021-04-27,PAB,2226,1013,1213,1150,1076,ITH,ITH1,4,Provincia Autonoma Bolzano / Bozen
2021-01-20,FVG,748,320,428,13,735,ITH,ITH4,6,Friuli-Venezia Giulia
2021-01-23,EMR,2447,870,1577,443,2004,ITH,ITH5,8,Emilia-Romagna
2021-01-28,CAM,8832,4121,4711,134,8698,ITF,ITF3,15,Campania
2021-01-03,BAS,900,344,556,900,0,ITF,ITF5,17,Basilicata
2021-01-12,LIG,2460,886,1574,2460,0,ITC,ITC3,7,Liguria
2021-03-07,EMR,6860,2640,4220,5343,1517,ITH,ITH5,8,Emilia-Romagna
2021-01-22,SIC,1249,632,617,243,1006,ITG,ITG1,19,Sicilia
2021-01-29,SIC,9355,4317,5038,426,8929,ITG,ITG1,19,Sicilia
2021-02-19,PAT,927,358,569,869,58,ITH,ITH2,4,Provincia Autonoma Trento
2021-03-29,LIG,10441,4511,5930,7311,3130,ITC,ITC3,7,Liguria
2021-04-23,BAS,4528,2177,2351,3528,1000,ITF,ITF5,17,Basilicata
2020-12-28,PIE,1,1,0,1,0,ITC,ITC1,1,Piemonte
2021-01-30,BAS,704,227,477,128,576,ITF,ITF5,17,Basilicata
2021-03-22,SAR,3550,1363,2187,3037,513,ITG,ITG2,20,Sardegna
2021-04-28,PAT,4241,1972,2269,4103,138,ITH,ITH2,4,Provincia Autonoma Trento
2021-05-19,LIG,13514,5949,7565,10407,3107,ITC,ITC3,7,Liguria
2021-02-12,LAZ,6843,2845,3998,6432,411,ITI,ITI4,12,Lazio
2021-04-14,MOL,1787,761,1026,1135,652,ITF,ITF2,14,Molise
2021-05-11,TOS,27907,12964,14943,12463,15444,ITI,ITI1,9,Toscana
2021-01-05,CAL,1457,680,777,1457,0,ITF,ITF6,18,Calabria
2021-01-19,CAM,1095,474,621,1092,3,ITF,ITF3,15,Campania
2021-01-13,PIE,10080,3223,6857,10080,0,ITC,ITC1,1,Piemonte
2021-01-17,UMB,54,17,37,54,0,ITI,ITI2,10,Umbria
2021-01-19,PAT,405,77,328,405,0,ITH,ITH2,4,Provincia Autonoma Trento
2021-02-05,ABR,1534,521,1013,788,746,ITF,ITF1,13,Abruzzo
2021-03-11,LOM,36201,13464,22737,26304,9897,ITC,ITC4,3,Lombardia
2021-03-24,CAL,7430,3392,4038,4255,3175,ITF,ITF6,18,Calabria
2021-05-03,PIE,26617,12149,14468,12484,14133,ITC,ITC1,1,Piemonte
2021-04-21,LAZ,32954,14965,17989,20594,12360,ITI,ITI4,12,Lazio
2021-01-18,MOL,114,48,66,114,0,ITF,ITF2,14,Molise
2021-04-14,VEN,15867,6878,8989,9239,6628,ITH,ITH3,5,Veneto
2021-02-02,LOM,19849,6584,13265,491,19358,ITC,ITC4,3,Lombardia
2021-02-08,LIG,1977,742,1235,306,1671,ITC,ITC3,7,Liguria
2021-02-11,VEN,4015,1239,2776,3385,630,ITH,ITH3,5,Veneto
2021-04-13,PIE,25911,11596,14315,22465,3446,ITC,ITC1,1,Piemonte
2021-01-25,LAZ,8111,3246,4865,771,7340,ITI,ITI4,12,Lazio
2021-03-11,CAM,17578,8669,8909,10300,7278,ITF,ITF3,15,Campania
2021-04-15,PAB,4399,2307,2092,4136,263,ITH,ITH1,4,Provincia Autonoma Bolzano / Bozen
2021-04-26,UMB,5365,2324,3041,3113,2252,ITI,ITI2,10,Umbria
2021-01-05,FVG,1678,551,1127,1678,0,ITH,ITH4,6,Friuli-Venezia Giulia
2021-01-20,LOM,5608,1373,4235,5493,115,ITC,ITC4,3,Lombardia
2021-04-30,LAZ,41132,18214,22918,27029,14103,ITI,ITI4,12,Lazio
2021-03-02,EMR,11816,3893,7923,9795,2021,ITH,ITH5,8,Emilia-Romagna
2021-04-18,VDA,522,254,268,518,4,ITC,ITC2,2,Valle d'Aosta / Vallée d'Aoste
2021-02-19,TOS,8290,2951,5339,7780,510,ITI,ITI1,9,Toscana
2021-04-20,ABR,5589,2689,2900,4179,1410,ITF,ITF1,13,Abruzzo
2021-02-19,PUG,4730,2010,2720,4339,391,ITF,ITF4,16,Puglia
2021-03-19,UMB,1743,565,1178,1087,656,ITI,ITI2,10,Umbria
2021-01-16,CAL,2394,1120,1274,2394,0,ITF,ITF6,18,Calabria
2021-01-16,FVG,1230,360,870,1230,0,ITH,ITH4,6,Friuli-Venezia Giulia
2021-03-18,SIC,15602,7783,7819,9864,5738,ITG,ITG1,19,Sicilia
2021-03-21,MAR,4505,1873,2632,1629,2876,ITI,ITI3,11,Marche
2021-03-26,CAL,7646,3626,4020,4528,3118,ITF,ITF6,18,Calabria
2021-02-03,BAS,666,300,366,32,634,ITF,ITF5,17,Basilicata
2021-01-21,MAR,897,253,644,585,312,ITI,ITI3,11,Marche
2021-02-02,CAM,5723,2804,2919,444,5279,ITF,ITF3,15,Campania
2021-02-26,LAZ,13079,5701,7378,11717,1362,ITI,ITI4,12,Lazio
2021-04-28,PUG,19529,8736,10793,14817,4712,ITF,ITF4,16,Puglia
2021-03-05,VDA,275,124,151,53,222,ITC,ITC2,2,Valle d'Aosta / Vallée d'Aoste
2021-04-28,TOS,19093,8174,10919,3827,15266,ITI,ITI1,9,Toscana
2021-05-16,SIC,33097,16118,16979,21774,11323,ITG,ITG1,19,Sicilia
2021-01-02,CAL,165,94,71,165,0,ITF,ITF6,18,Calabria
2021-01-02,LOM,199,72,127,199,0,ITC,ITC4,3,Lombardia
2021-04-12,LAZ,23684,10640,13044,16787,6897,ITI,ITI4,12,Lazio
2021-03-13,EMR,16065,6305,9760,10753,5312,ITH,ITH5,8,Emilia-Romagna
2021-03-28,PAB,569,212,357,11,558,ITH,ITH1,4,Provincia Autonoma Bolzano / Bozen
2021-03-30,PIE,17211,7175,10036,9020,8191,ITC,ITC1,1,Piemonte
2021-04-16,UMB,8099,3741,4358,6262,1837,ITI,ITI2,10,Umbria
2021-05-01,CAL,16467,7858,8609,12412,4055,ITF,ITF6,18,Calabria
2021-01-28,PAT,530,147,383,48,482,ITH,ITH2,4,Provincia Autonoma Trento
2021-01-16,VDA,236,80,156,236,0,ITC,ITC2,2,Valle d'Aosta / Vallée d'Aoste
2021-02-17,LAZ,9179,4601,4578,8305,874,ITI,ITI4,12,Lazio
2021-04-10,SAR,10480,4741,5739,8545,1935,ITG,ITG2,20,Sardegna
2021-01-24,CAL,44,18,26,39,5,ITF,ITF6,18,Calabria
2021-02-10,MOL,150,78,72,130,20,ITF,ITF2,14,Molise
2021-05-05,BAS,4331,2046,2285,3441,890,ITF,ITF5,17,Basilicata
2021-01-14,EMR,8098,2578,5520,8098,0,ITH,ITH5,8,Emilia-Romagna
2021-03-23,CAL,5203,2441,2762,3406,1797,ITF,ITF6,18,Calabria
2021-03-28,UMB,1096,442,654,1072,24,ITI,ITI2,10,Umbria
2021-03-30,CAL,5789,2490,3299,3195,2594,ITF,ITF6,18,Calabria
2021-04-16,ABR,7535,3488,4047,5618,1917,ITF,ITF1,13,Abruzzo
2021-01-30,ABR,1510,567,943,69,1441,ITF,ITF1,13,Abruzzo
2021-02-03,PAT,846,314,532,414,432,ITH,ITH2,4,Provincia Autonoma Trento
2021-04-06,VDA,741,381,360,629,112,ITC,ITC2,2,Valle d'Aosta / Vallée d'Aoste
2021-01-14,VEN,7061,1923,5138,7061,0,ITH,ITH3,5,Veneto
2021-02-15,MOL,144,70,74,141,3,ITF,ITF2,14,Molise
2021-03-24,SAR,7286,2998,4288,5927,1359,ITG,ITG2,20,Sardegna
2021-05-05,PIE,32024,14996,17028,19037,12987,ITC,ITC1,1,Piemonte
2021-05-10,LAZ,44108,20104,24004,30739,13369,ITI,ITI4,12,Lazio
2021-05-17,VDA,808,417,391,375,433,ITC,ITC2,2,Valle d'Aosta / Vallée d'Aoste
2021-01-03,PUG,2007,943,1064,2007,0,ITF,ITF4,16,Puglia
2021-02-04,VDA,294,86,208,8,286,ITC,ITC2,2,Valle d'Aosta / Vallée d'Aoste
2021-01-04,CAM,5825,2962,2863,5825,0,ITF,ITF3,15,Campania
2021-01-12,VEN,5230,1516,3714,5230,0,ITH,ITH3,5,Veneto
2021-02-14,PUG,787,348,439,663,124,ITF,ITF4,16,Puglia
2021-03-16,PAT,1391,506,885,608,783,ITH,ITH2,4,Provincia Autonoma Trento
2021-04-02,SAR,8987,3547,5440,5745,3242,ITG,ITG2,20,Sardegna
2021-04-16,SAR,14442,6489,7953,9099,5343,ITG,ITG2,20,Sardegna
2021-05-19,PAB,3540,1802,1738,1783,1757,ITH,ITH1,4,Provincia Autonoma Bolzano / Bozen
2021-01-12,PAB,1709,459,1250,1709,0,ITH,ITH1,4,Provincia Autonoma Bolzano / Bozen
2021-04-19,UMB,5012,2214,2798,2963,2049,ITI,ITI2,10,Umbria
2021-01-23,VEN,4050,1246,2804,32,4018,ITH,ITH3,5,Veneto
2021-01-24,SAR,90,34,56,5,85,ITG,ITG2,20,Sardegna
2021-03-07,VEN,4471,1754,2717,3910,561,ITH,ITH3,5,Veneto
2021-03-30,BAS,2739,1156,1583,2394,345,ITF,ITF5,17,Basilicata
2021-04-06,FVG,6275,2771,3504,5126,1149,ITH,ITH4,6,Friuli-Venezia Giulia
2021-01-10,BAS,77,24,53,77,0,ITF,ITF5,17,Basilicata
2021-01-11,LOM,16138,5352,10786,16138,0,ITC,ITC4,3,Lombardia
2021-01-30,PIE,5979,2135,3844,218,5761,ITC,ITC1,1,Piemonte
2021-02-04,FVG,2725,807,1918,36,2689,ITH,ITH4,6,Friuli-Venezia Giulia
2021-03-28,LIG,1142,511,631,391,751,ITC,ITC3,7,Liguria
2021-04-08,CAM,28264,13637,14627,22431,5833,ITF,ITF3,15,Campania
2021-04-24,VDA,722,400,322,555,167,ITC,ITC2,2,Valle d'Aosta / Vallée d'Aoste
2021-05-22,PAB,6816,3549,3267,4654,2162,ITH,ITH1,4,Provincia Autonoma Bolzano / Bozen
2021-03-21,VDA,355,165,190,355,0,ITC,ITC2,2,Valle d'Aosta / Vallée d'Aoste
2021-04-18,MAR,8820,4131,4689,7899,921,ITI,ITI3,11,Marche
2021-02-05,BAS,984,443,541,64,920,ITF,ITF5,17,Basilicata
2021-04-09,PUG,21802,9367,12435,17181,4621,ITF,ITF4,16,Puglia
2021-05-14,LOM,85298,41089,44209,55448,29850,ITC,ITC4,3,Lombardia
2021-03-02,VEN,11476,4618,6858,8171,3305,ITH,ITH3,5,Veneto
2021-04-01,FVG,6315,2993,3322,5300,1015,ITH,ITH4,6,Friuli-Venezia Giulia
2021-02-25,PUG,11950,5050,6900,10789,1161,ITF,ITF4,16,Puglia
2020-12-28,CAL,6,2,4,6,0,ITF,ITF6,18,Calabria
2021-04-25,FVG,2361,990,1371,2350,11,ITH,ITH4,6,Friuli-Venezia Giulia
2021-03-19,LIG,5296,2235,3061,2149,3147,ITC,ITC3,7,Liguria
2021-05-20,VDA,807,363,444,367,440,ITC,ITC2,2,Valle d'Aosta / Vallée d'Aoste
2021-05-22,UMB,6820,2674,4146,2573,4247,ITI,ITI2,10,Umbria
2021-02-13,SAR,1456,565,891,1454,2,ITG,ITG2,20,Sardegna
2021-05-01,PIE,28517,12988,15529,16721,11796,ITC,ITC1,1,Piemonte
2021-01-15,CAM,4980,2381,2599,4980,0,ITF,ITF3,15,Campania
2021-05-14,FVG,10545,5224,5321,8076,2469,ITH,ITH4,6,Friuli-Venezia Giulia
2021-01-01,SIC,815,437,378,815,0,ITG,ITG1,19,Sicilia
2021-03-15,CAM,12931,6088,6843,8187,4744,ITF,ITF3,15,Campania
2021-04-11,LAZ,19115,8431,10684,13234,5881,ITI,ITI4,12,Lazio
2021-04-20,FVG,7104,3058,4046,3202,3902,ITH,ITH4,6,Friuli-Venezia Giulia
2021-05-02,LOM,83502,38332,45170,61046,22456,ITC,ITC4,3,Lombardia
2021-05-19,UMB,9364,4189,5175,5632,3732,ITI,ITI2,10,Umbria
2021-01-03,PAT,492,160,332,492,0,ITH,ITH2,4,Provincia Autonoma Trento
2021-02-06,PIE,7984,2664,5320,400,7584,ITC,ITC1,1,Piemonte
2021-02-03,CAM,8903,4003,4900,878,8025,ITF,ITF3,15,Campania
2021-02-06,SAR,1970,697,1273,569,1401,ITG,ITG2,20,Sardegna
2021-02-14,PAT,246,186,60,11,235,ITH,ITH2,4,Provincia Autonoma Trento
2021-02-20,MOL,1018,441,577,998,20,ITF,ITF2,14,Molise
2021-04-14,EMR,26917,12773,14144,20849,6068,ITH,ITH5,8,Emilia-Romagna
2021-01-04,PAT,870,227,643,870,0,ITH,ITH2,4,Provincia Autonoma Trento
2021-02-22,UMB,1859,778,1081,1773,86,ITI,ITI2,10,Umbria
2021-03-16,PUG,9864,4683,5181,3508,6356,ITF,ITF4,16,Puglia
2021-05-01,SAR,9848,4734,5114,5425,4423,ITG,ITG2,20,Sardegna
2021-05-02,UMB,3787,1868,1919,1333,2454,ITI,ITI2,10,Umbria
2021-05-09,ABR,9153,4089,5064,4281,4872,ITF,ITF1,13,Abruzzo
2021-01-02,ABR,548,218,330,548,0,ITF,ITF1,13,Abruzzo
2021-02-11,EMR,4250,1416,2834,3410,840,ITH,ITH5,8,Emilia-Romagna
2021-04-01,CAL,8322,3761,4561,3838,4484,ITF,ITF6,18,Calabria
2021-05-05,ABR,11571,5540,6031,6443,5128,ITF,ITF1,13,Abruzzo
2021-05-22,LOM,69376,33331,36045,32200,37176,ITC,ITC4,3,Lombardia
2021-01-15,LOM,25206,7430,17776,25206,0,ITC,ITC4,3,Lombardia
2021-02-28,VDA,260,86,174,77,183,ITC,ITC2,2,Valle d'Aosta / Vallée d'Aoste
2021-04-16,PIE,28332,13184,15148,23390,4942,ITC,ITC1,1,Piemonte
2021-05-18,SIC,36047,17272,18775,23495,12552,ITG,ITG1,19,Sicilia
2020-12-27,TOS,620,267,353,620,0,ITI,ITI1,9,Toscana
2021-02-01,LIG,2558,923,1635,90,2468,ITC,ITC3,7,Liguria
2021-03-17,LAZ,13787,5897,7890,7532,6255,ITI,ITI4,12,Lazio
2021-04-09,PAT,2706,1144,1562,1507,1199,ITH,ITH2,4,Provincia Autonoma Trento
2021-05-14,CAL,19837,9542,10295,13036,6801,ITF,ITF6,18,Calabria
2021-04-09,CAM,29844,13965,15879,23717,6127,ITF,ITF3,15,Campania
2021-01-06,FVG,710,264,446,710,0,ITH,ITH4,6,Friuli-Venezia Giulia
2021-01-13,BAS,916,387,529,916,0,ITF,ITF5,17,Basilicata
2021-02-06,ABR,1610,742,868,602,1008,ITF,ITF1,13,Abruzzo
2021-02-25,PAT,1640,643,997,1200,440,ITH,ITH2,4,Provincia Autonoma Trento
2021-03-06,LAZ,18288,7042,11246,14031,4257,ITI,ITI4,12,Lazio
2021-03-12,SIC,13109,5609,7500,10893,2216,ITG,ITG1,19,Sicilia
2021-04-07,VEN,35862,16094,19768,28532,7330,ITH,ITH3,5,Veneto
2021-04-09,VEN,31095,13692,17403,22758,8337,ITH,ITH3,5,Veneto
2021-01-31,VDA,291,91,200,58,233,ITC,ITC2,2,Valle d'Aosta / Vallée d'Aoste
2021-02-27,SIC,12430,5560,6870,11226,1204,ITG,ITG1,19,Sicilia
2021-04-15,LIG,11814,5218,6596,9962,1852,ITC,ITC3,7,Liguria
2021-05-04,MAR,10842,4787,6055,4949,5893,ITI,ITI3,11,Marche
2021-03-10,TOS,18011,7073,10938,13994,4017,ITI,ITI1,9,Toscana
2021-05-03,CAL,14654,6714,7940,10533,4121,ITF,ITF6,18,Calabria
2021-04-10,PIE,30158,13414,16744,25880,4278,ITC,ITC1,1,Piemonte
2021-03-03,LAZ,17376,7425,9951,13082,4294,ITI,ITI4,12,Lazio
2021-03-21,LIG,552,221,331,69,483,ITC,ITC3,7,Liguria
2021-04-29,LOM,115330,53527,61803,85553,29777,ITC,ITC4,3,Lombardia
2021-05-14,PIE,32776,15955,16821,17518,15258,ITC,ITC1,1,Piemonte
2021-01-28,FVG,2238,794,1444,354,1884,ITH,ITH4,6,Friuli-Venezia Giulia
2021-01-29,PAB,1497,510,987,24,1473,ITH,ITH1,4,Provincia Autonoma Bolzano / Bozen
2021-02-06,BAS,902,367,535,146,756,ITF,ITF5,17,Basilicata
2021-04-08,ABR,7338,3317,4021,5060,2278,ITF,ITF1,13,Abruzzo
2021-04-05,VDA,461,222,239,457,4,ITC,ITC2,2,Valle d'Aosta / Vallée d'Aoste
2021-04-16,BAS,3320,1633,1687,2421,899,ITF,ITF5,17,Basilicata
2021-05-12,SAR,10228,4593,5635,7162,3066,ITG,ITG2,20,Sardegna
2021-01-20,CAL,1397,624,773,1396,1,ITF,ITF6,18,Calabria
2021-03-11,FVG,3353,1413,1940,1604,1749,ITH,ITH4,6,Friuli-Venezia Giulia
2021-04-13,PAT,2546,1054,1492,2039,507,ITH,ITH2,4,Provincia Autonoma Trento
2021-04-19,SAR,10176,4612,5564,8759,1417,ITG,ITG2,20,Sardegna
2021-05-06,LOM,89602,42127,47475,73277,16325,ITC,ITC4,3,Lombardia
2021-02-08,SAR,1470,533,937,856,614,ITG,ITG2,20,Sardegna
2021-02-11,LOM,17043,5003,12040,9699,7344,ITC,ITC4,3,Lombardia
2021-04-14,CAM,27638,13330,14308,19073,8565,ITF,ITF3,15,Campania
2021-05-20,LIG,12785,5931,6854,8770,4015,ITC,ITC3,7,Liguria
2021-03-17,MAR,3428,1494,1934,107,3321,ITI,ITI3,11,Marche
2021-03-30,CAM,21727,10270,11457,18769,2958,ITF,ITF3,15,Campania
2021-03-30,PUG,11836,5485,6351,5968,5868,ITF,ITF4,16,Puglia
2021-03-06,MAR,5700,2623,3077,4433,1267,ITI,ITI3,11,Marche
2021-03-11,CAL,6877,3276,3601,5620,1257,ITF,ITF6,18,Calabria
2021-01-27,MOL,674,251,423,8,666,ITF,ITF2,14,Molise
2021-04-03,VDA,676,341,335,661,15,ITC,ITC2,2,Valle d'Aosta / Vallée d'Aoste
2021-04-30,TOS,39940,17651,22289,20113,19827,ITI,ITI1,9,Toscana
2021-03-01,LAZ,17086,7344,9742,13201,3885,ITI,ITI4,12,Lazio
2021-03-18,UMB,2942,1164,1778,1704,1238,ITI,ITI2,10,Umbria
2021-02-13,BAS,799,313,486,738,61,ITF,ITF5,17,Basilicata
2021-02-16,LAZ,8355,4033,4322,7750,605,ITI,ITI4,12,Lazio
2020-12-30,PAT,7,3,4,7,0,ITH,ITH2,4,Provincia Autonoma Trento
2021-03-18,PAB,1302,531,771,226,1076,ITH,ITH1,4,Provincia Autonoma Bolzano / Bozen
2021-03-24,BAS,1745,680,1065,1350,395,ITF,ITF5,17,Basilicata
2021-05-02,ABR,10421,5086,5335,5212,5209,ITF,ITF1,13,Abruzzo
2021-05-04,MOL,2702,1179,1523,2574,128,ITF,ITF2,14,Molise
2021-02-26,MOL,563,260,303,490,73,ITF,ITF2,14,Molise
2021-03-25,EMR,21371,9336,12035,14384,6987,ITH,ITH5,8,Emilia-Romagna
2021-04-21,TOS,29584,12654,16930,17501,12083,ITI,ITI1,9,Toscana
2021-05-03,PUG,33021,14746,18275,22417,10604,ITF,ITF4,16,Puglia
2021-03-30,PAT,2387,973,1414,1750,637,ITH,ITH2,4,Provincia Autonoma Trento
2021-05-03,PAT,4234,2178,2056,4081,153,ITH,ITH2,4,Provincia Autonoma Trento
2020-12-30,TOS,327,104,223,327,0,ITI,ITI1,9,Toscana
2021-02-11,PAB,1092,431,661,239,853,ITH,ITH1,4,Provincia Autonoma Bolzano / Bozen
2021-05-15,MOL,2978,1397,1581,2594,384,ITF,ITF2,14,Molise
2021-01-01,SAR,32,17,15,32,0,ITG,ITG2,20,Sardegna
2021-01-06,LAZ,5121,1961,3160,5121,0,ITI,ITI4,12,Lazio
2021-03-09,MOL,1329,579,750,1177,152,ITF,ITF2,14,Molise
2021-04-02,BAS,2318,1046,1272,1714,604,ITF,ITF5,17,Basilicata
2021-04-12,MOL,1261,547,714,1019,242,ITF,ITF2,14,Molise
2021-04-29,PAB,2630,1351,1279,1936,694,ITH,ITH1,4,Provincia Autonoma Bolzano / Bozen
2021-04-15,UMB,7626,3482,4144,5740,1886,ITI,ITI2,10,Umbria
2021-04-24,MAR,12026,5304,6722,7560,4466,ITI,ITI3,11,Marche
2021-05-18,SAR,13059,6329,6730,9146,3913,ITG,ITG2,20,Sardegna
2021-02-10,PAB,1635,604,1031,26,1609,ITH,ITH1,4,Provincia Autonoma Bolzano / Bozen
2021-02-27,LIG,1888,921,967,1759,129,ITC,ITC3,7,Liguria
2021-03-14,LAZ,17081,6606,10475,11927,5154,ITI,ITI4,12,Lazio
2021-02-18,VDA,349,153,196,261,88,ITC,ITC2,2,Valle d'Aosta / Vallée d'Aoste
2021-02-20,EMR,5317,2094,3223,5053,264,ITH,ITH5,8,Emilia-Romagna
2021-02-22,SAR,1639,949,690,1411,228,ITG,ITG2,20,Sardegna
2021-03-02,ABR,3963,1676,2287,3279,684,ITF,ITF1,13,Abruzzo
2021-04-13,PUG,28594,13552,15042,25197,3397,ITF,ITF4,16,Puglia
2021-05-16,PAB,2024,931,1093,1330,694,ITH,ITH1,4,Provincia Autonoma Bolzano / Bozen
2021-02-19,VDA,292,102,190,268,24,ITC,ITC2,2,Valle d'Aosta / Vallée d'Aoste
2021-05-15,VEN,35937,17371,18566,26035,9902,ITH,ITH3,5,Veneto
2021-05-16,UMB,5307,2531,2776,5255,52,ITI,ITI2,10,Umbria
2021-03-04,SAR,4002,1953,2049,2747,1255,ITG,ITG2,20,Sardegna
2021-03-22,PIE,11692,4968,6724,3877,7815,ITC,ITC1,1,Piemonte
2021-04-29,UMB,5203,2244,2959,2877,2326,ITI,ITI2,10,Umbria
2021-05-09,CAL,9611,4488,5123,6133,3478,ITF,ITF6,18,Calabria
2021-05-22,ABR,13058,6347,6711,8170,4888,ITF,ITF1,13,Abruzzo
2021-01-10,PUG,2348,1061,1287,2348,0,ITF,ITF4,16,Puglia
2021-03-27,MOL,2738,1272,1466,1305,1433,ITF,ITF2,14,Molise
2021-04-25,LAZ,24468,11196,13272,16658,7810,ITI,ITI4,12,Lazio
2021-02-10,VEN,4751,1588,3163,3697,1054,ITH,ITH3,5,Veneto
2021-02-11,UMB,842,349,493,837,5,ITI,ITI2,10,Umbria
2021-02-15,EMR,2900,849,2051,2774,126,ITH,ITH5,8,Emilia-Romagna
2021-03-04,PIE,14492,5733,8759,11545,2947,ITC,ITC1,1,Piemonte
2021-03-14,TOS,7207,2574,4633,3272,3935,ITI,ITI1,9,Toscana
2021-05-09,FVG,7325,3289,4036,3473,3852,ITH,ITH4,6,Friuli-Venezia Giulia
2021-01-24,BAS,836,300,536,58,778,ITF,ITF5,17,Basilicata
2021-05-11,SIC,32479,15435,17044,19869,12610,ITG,ITG1,19,Sicilia
2021-01-11,ABR,1551,557,994,1551,0,ITF,ITF1,13,Abruzzo
2021-01-13,CAM,8020,3666,4354,8020,0,ITF,ITF3,15,Campania
2021-05-23,SAR,7227,3492,3735,5203,2024,ITG,ITG2,20,Sardegna
2020-12-30,PUG,1,0,1,1,0,ITF,ITF4,16,Puglia
2021-03-27,VEN,32052,13991,18061,26246,5806,ITH,ITH3,5,Veneto
2021-05-23,PIE,25081,11448,13633,13212,11869,ITC,ITC1,1,Piemonte
2021-01-03,CAM,3837,2009,1828,3837,0,ITF,ITF3,15,Campania
2021-02-07,PUG,1578,669,909,253,1325,ITF,ITF4,16,Puglia
2021-03-24,PIE,15503,6339,9164,6378,9125,ITC,ITC1,1,Piemonte
2020-12-27,SIC,91,55,36,91,0,ITG,ITG1,19,Sicilia
2021-02-15,PAB,72,42,30,26,46,ITH,ITH1,4,Provincia Autonoma Bolzano / Bozen
2021-05-02,FVG,6806,3200,3606,3910,2896,ITH,ITH4,6,Friuli-Venezia Giulia
2021-04-08,CAL,9307,4380,4927,5673,3634,ITF,ITF6,18,Calabria
2021-05-01,CAM,46316,22651,23665,30219,16097,ITF,ITF3,15,Campania
2021-01-21,SIC,1357,662,695,500,857,ITG,ITG1,19,Sicilia
2021-02-14,TOS,8999,2569,6430,8889,110,ITI,ITI1,9,Toscana
2021-02-23,LAZ,11083,4780,6303,10322,761,ITI,ITI4,12,Lazio
2021-03-12,PAB,1664,734,930,1251,413,ITH,ITH1,4,Provincia Autonoma Bolzano / Bozen
2021-03-25,PAT,2874,1103,1771,1824,1050,ITH,ITH2,4,Provincia Autonoma Trento
2021-01-05,PUG,5104,2249,2855,5104,0,ITF,ITF4,16,Puglia
2021-05-10,MOL,2876,1279,1597,2515,361,ITF,ITF2,14,Molise
2021-03-23,PIE,13063,5447,7616,6821,6242,ITC,ITC1,1,Piemonte
2021-04-17,SIC,26182,13224,12958,19030,7152,ITG,ITG1,19,Sicilia
2021-01-11,FVG,1884,609,1275,1884,0,ITH,ITH4,6,Friuli-Venezia Giulia
2021-01-24,PIE,3153,959,2194,434,2719,ITC,ITC1,1,Piemonte
2021-01-29,LIG,3079,1064,2015,67,3012,ITC,ITC3,7,Liguria
2021-04-22,LAZ,38435,18883,19552,23901,14534,ITI,ITI4,12,Lazio
2021-05-18,PAB,3285,1716,1569,2121,1164,ITH,ITH1,4,Provincia Autonoma Bolzano / Bozen
2021-01-21,MOL,6,2,4,6,0,ITF,ITF2,14,Molise
2021-01-04,VDA,142,59,83,142,0,ITC,ITC2,2,Valle d'Aosta / Vallée d'Aoste
2021-02-13,MOL,132,80,52,132,0,ITF,ITF2,14,Molise
2021-02-22,CAL,1997,1013,984,1442,555,ITF,ITF6,18,Calabria
2021-04-10,CAL,11149,5023,6126,6339,4810,ITF,ITF6,18,Calabria
2021-04-15,SAR,11801,5519,6282,6847,4954,ITG,ITG2,20,Sardegna
2021-05-01,PUG,27336,12529,14807,16700,10636,ITF,ITF4,16,Puglia
2021-01-22,LIG,1816,604,1212,1330,486,ITC,ITC3,7,Liguria
2021-02-10,EMR,4015,1381,2634,2761,1254,ITH,ITH5,8,Emilia-Romagna
2021-02-15,VEN,4386,1821,2565,4146,240,ITH,ITH3,5,Veneto
2021-02-25,VDA,201,101,100,194,7,ITC,ITC2,2,Valle d'Aosta / Vallée d'Aoste
2021-03-22,BAS,1175,531,644,628,547,ITF,ITF5,17,Basilicata
2021-04-19,CAL,7652,3686,3966,6072,1580,ITF,ITF6,18,Calabria
2021-02-09,TOS,4488,1468,3020,3877,611,ITI,ITI1,9,Toscana
2021-03-31,LAZ,26079,12031,14048,18987,7092,ITI,ITI4,12,Lazio
2021-05-02,CAL,12422,5799,6623,10649,1773,ITF,ITF6,18,Calabria
2021-05-21,SIC,43236,20302,22934,22453,20783,ITG,ITG1,19,Sicilia
2021-01-08,LAZ,7726,2894,4832,7726,0,ITI,ITI4,12,Lazio
2021-03-02,LOM,22823,9700,13123,19789,3034,ITC,ITC4,3,Lombardia
2021-03-13,VEN,17176,7257,9919,14043,3133,ITH,ITH3,5,Veneto
2021-03-22,CAL,4702,2201,2501,3036,1666,ITF,ITF6,18,Calabria
2021-05-12,LOM,86934,41521,45413,59684,27250,ITC,ITC4,3,Lombardia
2021-01-26,PUG,5360,2397,2963,571,4789,ITF,ITF4,16,Puglia
2021-02-20,SIC,7241,3725,3516,6999,242,ITG,ITG1,19,Sicilia
2021-03-16,TOS,4898,1881,3017,2654,2244,ITI,ITI1,9,Toscana
2021-04-20,CAL,7645,3851,3794,6017,1628,ITF,ITF6,18,Calabria
2021-04-27,LAZ,30573,13789,16784,19738,10835,ITI,ITI4,12,Lazio
2021-05-18,UMB,7687,3327,4360,3850,3837,ITI,ITI2,10,Umbria
2021-01-02,PIE,3545,1134,2411,3545,0,ITC,ITC1,1,Piemonte
2021-01-27,EMR,8359,2947,5412,464,7895,ITH,ITH5,8,Emilia-Romagna
2021-04-08,LOM,52320,21752,30568,35866,16454,ITC,ITC4,3,Lombardia
2021-02-09,LAZ,8797,3768,5029,4580,4217,ITI,ITI4,12,Lazio
2021-03-07,CAM,11912,5344,6568,8069,3843,ITF,ITF3,15,Campania
2021-03-25,PUG,10883,5286,5597,4651,6232,ITF,ITF4,16,Puglia
2021-03-27,EMR,21550,9019,12531,14655,6895,ITH,ITH5,8,Emilia-Romagna
2021-05-16,LIG,3684,1851,1833,2133,1551,ITC,ITC3,7,Liguria
2021-01-15,FVG,2021,605,1416,2021,0,ITH,ITH4,6,Friuli-Venezia Giulia
2021-03-13,LOM,27127,9756,17371,21070,6057,ITC,ITC4,3,Lombardia
2021-01-12,UMB,838,248,590,838,0,ITI,ITI2,10,Umbria
2021-01-14,LOM,26800,7782,19018,26800,0,ITC,ITC4,3,Lombardia
2021-02-02,ABR,1778,672,1106,222,1556,ITF,ITF1,13,Abruzzo
2021-03-10,SIC,13939,5953,7986,11554,2385,ITG,ITG1,19,Sicilia
2021-04-02,MOL,1405,691,714,644,761,ITF,ITF2,14,Molise
2021-04-10,BAS,1031,377,654,950,81,ITF,ITF5,17,Basilicata
2021-04-29,SAR,10734,4953,5781,6567,4167,ITG,ITG2,20,Sardegna
2021-01-01,PAB,6,5,1,6,0,ITH,ITH1,4,Provincia Autonoma Bolzano / Bozen
2021-02-20,VEN,6424,2014,4410,6353,71,ITH,ITH3,5,Veneto
2021-04-07,LOM,50522,20876,29646,34710,15812,ITC,ITC4,3,Lombardia
2021-04-27,TOS,10339,4907,5432,3860,6479,ITI,ITI1,9,Toscana
2021-03-17,TOS,11420,4586,6834,6892,4528,ITI,ITI1,9,Toscana
2021-02-17,MAR,1785,662,1123,1668,117,ITI,ITI3,11,Marche
2020-12-31,LAZ,5292,2121,3171,5292,0,ITI,ITI4,12,Lazio
2021-01-26,TOS,5393,1792,3601,220,5173,ITI,ITI1,9,Toscana
2021-05-01,PAT,4837,2463,2374,4802,35,ITH,ITH2,4,Provincia Autonoma Trento
2021-05-15,EMR,32637,14683,17954,22324,10313,ITH,ITH5,8,Emilia-Romagna
2021-03-06,TOS,7094,2838,4256,2901,4193,ITI,ITI1,9,Toscana
2021-03-09,EMR,14656,5953,8703,10700,3956,ITH,ITH5,8,Emilia-Romagna
2021-05-06,SAR,12355,5707,6648,9346,3009,ITG,ITG2,20,Sardegna
2021-01-01,UMB,274,105,169,274,0,ITI,ITI2,10,Umbria
2021-01-15,CAL,2795,1258,1537,2795,0,ITF,ITF6,18,Calabria
2021-01-23,LOM,1114,357,757,916,198,ITC,ITC4,3,Lombardia
2021-04-23,PUG,29164,13544,15620,23959,5205,ITF,ITF4,16,Puglia
2021-03-18,LIG,4982,2124,2858,2009,2973,ITC,ITC3,7,Liguria
2021-03-25,VEN,25829,10949,14880,19706,6123,ITH,ITH3,5,Veneto
2021-04-07,CAM,24756,11783,12973,20034,4722,ITF,ITF3,15,Campania
2021-05-12,PAB,3776,2048,1728,3623,153,ITH,ITH1,4,Provincia Autonoma Bolzano / Bozen
2021-01-26,PAT,542,154,388,27,515,ITH,ITH2,4,Provincia Autonoma Trento
2021-02-26,MAR,3630,1499,2131,3154,476,ITI,ITI3,11,Marche
2021-03-05,LIG,4869,2150,2719,3737,1132,ITC,ITC3,7,Liguria
2020-12-31,TOS,804,202,602,804,0,ITI,ITI1,9,Toscana
2021-05-08,SAR,12721,5854,6867,10574,2147,ITG,ITG2,20,Sardegna
